ID,op_status,total_funding_usd,funding_rounds,first_funding_date,last_funding_date,num_investors,funding_duration,first_funding_utc,last_funding_utc
0,operating,73600000,2,22-01-2014,24-06-2015,5,518,16092,16610
1,operating,28612936,3,02-04-2014,18-11-2015,7,595,16162,16757
2,acquired,,1,18-04-2013,18-04-2013,1,0,15813,15813
3,acquired,12700000,1,24-09-2008,24-09-2008,3,0,14146,14146
4,operating,,1,01-04-2015,01-04-2015,7,0,16526,16526
5,operating,10300000,2,16-10-2013,24-03-2015,7,524,15994,16518
6,operating,,1,12-01-2015,12-01-2015,1,0,16447,16447
7,closed,,1,17-11-2009,17-11-2009,1,0,14565,14565
8,closed,4000000,1,28-08-2008,28-08-2008,1,0,14119,14119
9,operating,1000000,1,20-04-2014,20-04-2014,1,0,16180,16180
10,acquired,15000000,1,13-06-2013,13-06-2013,1,0,15869,15869
11,operating,50811,1,01-02-2012,01-02-2012,1,0,15371,15371
12,operating,7000000,2,05-08-2014,14-07-2015,3,343,16287,16630
13,operating,3000000,1,03-02-2015,03-02-2015,1,0,16469,16469
14,acquired,19000000,2,28-04-2004,18-01-2006,2,630,12536,13166
15,operating,8411685,4,01-01-2012,20-10-2015,9,1388,15340,16728
16,operating,,1,12-01-2011,12-01-2011,1,0,14986,14986
17,operating,2200000,1,10-04-2007,10-04-2007,1,0,13613,13613
18,operating,1500000,1,01-01-2010,01-01-2010,3,0,14610,14610
19,operating,4000000,1,16-04-2014,16-04-2014,1,0,16176,16176
20,operating,,1,22-10-2013,22-10-2013,1,0,16000,16000
21,operating,50000000,1,01-03-2011,01-03-2011,1,0,15034,15034
22,operating,5462000,3,28-02-2012,26-01-2015,1,1063,15398,16461
23,operating,380000,6,28-08-2010,15-08-2012,6,718,14849,15567
24,operating,5000000,2,01-01-2007,04-05-2010,1,1219,13514,14733
25,operating,56600000,5,14-07-2003,08-05-2009,13,2125,12247,14372
26,acquired,11600000,1,02-12-1999,02-12-1999,4,0,10927,10927
27,operating,13000000,2,14-11-2012,14-04-2015,2,881,15658,16539
28,operating,24841531.73,1,31-05-2012,31-05-2012,1,0,15491,15491
29,operating,33840,1,12-05-2014,12-05-2014,1,0,16202,16202
30,operating,4900000,1,02-12-2014,02-12-2014,3,0,16406,16406
31,closed,7500000,1,16-04-2004,16-04-2004,3,0,12524,12524
32,operating,60000000,3,17-07-2012,17-07-2015,3,1095,15538,16633
33,operating,6100000,2,21-10-2013,29-09-2014,6,343,15999,16342
34,ipo,,1,07-10-1999,07-10-1999,1,0,10871,10871
35,operating,2000000,1,08-09-2014,08-09-2014,3,0,16321,16321
36,ipo,,1,29-01-2010,29-01-2010,1,0,14638,14638
37,operating,,1,01-02-2013,01-02-2013,1,0,15737,15737
38,operating,,1,01-04-2012,01-04-2012,1,0,15431,15431
39,operating,1100000,1,12-02-2013,12-02-2013,1,0,15748,15748
40,operating,50000000,1,13-10-2014,13-10-2014,1,0,16356,16356
41,operating,150000,1,06-11-2015,06-11-2015,1,0,16745,16745
42,operating,20000,1,01-05-2014,01-05-2014,1,0,16191,16191
43,operating,,1,01-08-2010,01-08-2010,1,0,14822,14822
44,operating,,2,01-11-2013,14-10-2014,3,347,16010,16357
45,operating,,1,01-09-2011,01-09-2011,1,0,15218,15218
46,operating,,1,01-11-2012,01-11-2012,1,0,15645,15645
47,operating,2796478,1,01-08-2011,01-08-2011,1,0,15187,15187
48,operating,1750000,1,07-07-2011,07-07-2011,2,0,15162,15162
49,operating,1500000,1,15-01-2014,15-01-2014,1,0,16085,16085
50,acquired,24000000,4,01-04-2006,01-11-2009,11,1310,13239,14549
51,closed,1200000,1,15-07-2015,15-07-2015,1,0,16631,16631
52,operating,100000000,1,24-03-2015,24-03-2015,1,0,16518,16518
53,operating,7050000,2,01-02-2008,15-01-2010,4,714,13910,14624
54,operating,20000000,1,26-10-2015,26-10-2015,3,0,16734,16734
55,operating,867685,1,14-01-2011,14-01-2011,2,0,14988,14988
56,operating,,2,30-01-2013,11-03-2013,2,40,15735,15775
57,operating,41250,1,01-07-2014,01-07-2014,1,0,16252,16252
58,acquired,,2,01-01-2008,15-09-2009,1,623,13879,14502
59,operating,75000000,2,20-12-2006,01-02-2011,2,1504,13502,15006
60,operating,18026455.55,4,01-12-2012,05-02-2015,16,796,15675,16471
61,operating,1480960,2,25-01-2012,24-08-2014,5,942,15364,16306
62,operating,,1,16-02-2015,16-02-2015,1,0,16482,16482
63,operating,38732500,2,01-04-2006,18-06-2008,3,809,13239,14048
64,operating,300000,1,26-06-2014,26-06-2014,5,0,16247,16247
65,operating,15000000,1,06-10-2005,06-10-2005,3,0,13062,13062
66,operating,248571,1,11-03-2015,11-03-2015,4,0,16505,16505
67,operating,1000000,1,12-01-2015,12-01-2015,4,0,16447,16447
68,operating,170000,3,10-06-2008,10-08-2013,1,1887,14040,15927
69,acquired,24750000,3,22-05-2006,21-09-2010,17,1583,13290,14873
70,operating,11119621.4,3,20-09-2010,11-08-2014,6,1421,14872,16293
71,operating,40000,1,09-08-2012,09-08-2012,1,0,15561,15561
72,operating,,1,08-10-2015,08-10-2015,1,0,16716,16716
73,acquired,26000000,3,29-01-2003,30-06-2006,8,1248,12081,13329
74,acquired,500000,1,01-01-2011,01-01-2011,1,0,14975,14975
75,operating,400000,1,01-01-2013,01-01-2013,1,0,15706,15706
76,operating,120000,1,01-12-2014,01-12-2014,1,0,16405,16405
77,acquired,7715715,2,16-02-2005,06-01-2010,1,1785,12830,14615
78,operating,42176988.7,1,03-09-2015,03-09-2015,4,0,16681,16681
79,operating,4500000,1,18-07-2005,18-07-2005,2,0,12982,12982
80,operating,37064136,2,26-03-2014,02-04-2015,9,372,16155,16527
81,acquired,9800000,2,26-02-2005,27-04-2006,6,425,12840,13265
82,operating,16300000,1,20-10-2014,20-10-2014,1,0,16363,16363
83,operating,,1,26-08-2011,26-08-2011,1,0,15212,15212
84,operating,2100000,1,08-09-2015,08-09-2015,5,0,16686,16686
85,acquired,,1,07-04-2011,07-04-2011,1,0,15071,15071
86,acquired,,1,01-01-1999,01-01-1999,1,0,10592,10592
87,operating,13960000,1,26-09-2006,26-09-2006,5,0,13417,13417
88,operating,13049,1,19-07-2014,19-07-2014,2,0,16270,16270
89,operating,100000,1,01-11-2014,01-11-2014,1,0,16375,16375
90,operating,75000000,4,27-07-2013,08-09-2015,14,773,15913,16686
91,operating,2000000,2,14-06-2014,06-11-2015,2,510,16235,16745
92,operating,,1,18-06-2015,18-06-2015,1,0,16604,16604
93,operating,2710000,4,01-05-2008,21-02-2013,4,1757,14000,15757
94,closed,100000,1,06-10-2015,06-10-2015,2,0,16714,16714
95,operating,82328527,5,11-10-2006,02-07-2014,8,2821,13432,16253
96,operating,,1,17-03-2015,17-03-2015,1,0,16511,16511
97,operating,307632220,8,27-10-2008,12-08-2015,18,2480,14179,16659
98,operating,22153,1,01-12-2012,01-12-2012,1,0,15675,15675
99,acquired,,1,21-04-2013,21-04-2013,1,0,15816,15816
100,operating,750000,2,24-06-2014,16-12-2014,1,175,16245,16420
101,operating,2000000,1,08-04-2015,08-04-2015,7,0,16533,16533
102,operating,597666.8721,5,01-03-2011,01-05-2015,8,1522,15034,16556
103,operating,,1,01-07-2012,01-07-2012,1,0,15522,15522
104,acquired,61120000,3,31-03-2005,28-08-2006,17,515,12873,13388
105,acquired,500000,1,28-03-2014,28-03-2014,2,0,16157,16157
106,operating,,1,15-01-2008,15-01-2008,1,0,13893,13893
107,operating,262424600,7,01-04-2011,30-07-2015,6,1581,15065,16646
108,operating,42500000,1,03-11-2015,03-11-2015,2,0,16742,16742
109,closed,3693500,1,08-12-2009,08-12-2009,1,0,14586,14586
110,operating,20000,1,16-10-2013,16-10-2013,1,0,15994,15994
111,operating,50000000,1,01-11-2011,01-11-2011,2,0,15279,15279
112,operating,507824.2501,2,31-10-2014,30-10-2015,3,364,16374,16738
113,operating,3200000,2,25-09-2013,11-03-2015,5,532,15973,16505
114,operating,5700000,3,01-08-2011,26-08-2014,1,1121,15187,16308
115,closed,,1,01-07-2014,01-07-2014,1,0,16252,16252
116,operating,100000000,1,11-08-2015,11-08-2015,5,0,16658,16658
117,closed,30000,1,01-04-2015,01-04-2015,1,0,16526,16526
118,operating,15000000,1,13-11-2006,13-11-2006,2,0,13465,13465
119,operating,50390000,2,21-09-2012,12-10-2012,1,21,15604,15625
120,closed,4700000,1,24-07-2008,24-07-2008,1,0,14084,14084
121,operating,2044050,1,01-11-2011,01-11-2011,1,0,15279,15279
122,operating,3000000,1,08-12-2014,08-12-2014,1,0,16412,16412
123,operating,1500000,3,12-09-2012,25-04-2014,7,590,15595,16185
124,operating,14603757,3,19-05-2003,21-08-2012,6,3382,12191,15573
125,acquired,6500000,1,14-05-2012,14-05-2012,8,0,15474,15474
126,operating,31500000,5,01-03-2006,09-09-2010,12,1653,13208,14861
127,operating,,3,01-03-2011,01-01-2012,3,306,15034,15340
128,acquired,,1,01-01-2012,01-01-2012,1,0,15340,15340
129,operating,12500000,1,28-01-2015,28-01-2015,2,0,16463,16463
130,operating,1344657.374,2,16-01-2011,26-10-2011,2,283,14990,15273
131,operating,19000000,2,12-04-2011,02-02-2012,5,296,15076,15372
132,operating,15120000,4,01-11-2011,20-11-2015,27,1480,15279,16759
133,operating,5000000,1,01-01-2008,01-01-2008,1,0,13879,13879
134,operating,,1,03-06-2013,03-06-2013,1,0,15859,15859
135,operating,8748376,4,01-08-2011,06-08-2014,14,1101,15187,16288
136,operating,,1,17-09-2015,17-09-2015,1,0,16695,16695
137,operating,900000,2,01-03-2013,07-05-2015,2,797,15765,16562
138,operating,38500000,3,01-01-2012,29-08-2014,21,971,15340,16311
139,operating,17328859,3,04-08-2009,14-07-2014,6,1805,14460,16265
140,operating,8250000,1,24-01-2001,24-01-2001,4,0,11346,11346
141,operating,,1,30-10-2014,30-10-2014,1,0,16373,16373
142,operating,2333428,4,25-10-2012,01-01-2015,10,798,15638,16436
143,operating,1200000,1,04-03-2013,04-03-2013,1,0,15768,15768
144,operating,10000000,1,17-12-2013,17-12-2013,1,0,16056,16056
145,operating,1349658,1,02-01-2007,02-01-2007,2,0,13515,13515
146,closed,5000000,1,01-10-2009,01-10-2009,1,0,14518,14518
147,operating,15000,1,01-03-2015,01-03-2015,1,0,16495,16495
148,operating,10000000,1,14-05-2012,14-05-2012,3,0,15474,15474
149,operating,4000000,1,01-07-2007,01-07-2007,2,0,13695,13695
150,acquired,6000000,1,14-01-2004,14-01-2004,1,0,12431,12431
151,operating,,1,15-05-2013,15-05-2013,1,0,15840,15840
152,closed,5000000,1,28-01-2005,28-01-2005,1,0,12811,12811
153,operating,2776316,2,17-04-2009,21-07-2014,1,1921,14351,16272
154,operating,451804,2,03-06-2013,31-03-2014,6,301,15859,16160
155,acquired,30250000,5,25-05-2005,27-02-2009,15,1374,12928,14302
156,operating,,1,12-02-1996,12-02-1996,1,0,9538,9538
157,ipo,750000000,1,08-04-2014,08-04-2014,1,0,16168,16168
158,operating,1800000,2,25-12-2013,24-06-2014,8,181,16064,16245
159,operating,10652300.69,7,01-04-2007,25-04-2014,7,2581,13604,16185
160,operating,,4,21-11-2012,28-07-2015,5,979,15665,16644
161,operating,1849000,2,22-04-2014,04-02-2015,3,288,16182,16470
162,operating,132787385,14,06-04-2005,02-03-2015,24,3617,12879,16496
163,operating,18400000,3,16-05-2012,18-06-2015,5,1128,15476,16604
164,operating,495498,4,08-07-2010,02-04-2015,3,1729,14798,16527
165,operating,9400000,2,10-04-2009,02-12-2011,1,966,14344,15310
166,operating,,1,01-02-2015,01-02-2015,1,0,16467,16467
167,operating,500000,1,05-05-2011,05-05-2011,1,0,15099,15099
168,acquired,,1,19-03-2008,19-03-2008,1,0,13957,13957
169,acquired,4400000,4,21-08-2001,16-06-2011,8,3586,11555,15141
170,operating,375000,1,01-04-2014,01-04-2014,1,0,16161,16161
171,operating,3049871,1,01-04-2014,01-04-2014,1,0,16161,16161
172,operating,3109003,2,22-01-2008,13-02-2015,5,2579,13900,16479
173,operating,882121,1,05-07-2011,05-07-2011,1,0,15160,15160
174,acquired,15000000,1,26-04-2010,26-04-2010,1,0,14725,14725
175,operating,475000,3,01-02-2011,05-12-2011,7,307,15006,15313
176,operating,643300,1,07-04-2014,07-04-2014,1,0,16167,16167
177,operating,57500000,6,21-08-2006,22-04-2014,19,2801,13381,16182
178,operating,540000,5,01-10-2010,25-03-2015,1,1636,14883,16519
179,operating,,3,01-01-2013,01-01-2014,2,365,15706,16071
180,operating,10000000,1,26-05-2005,26-05-2005,2,0,12929,12929
181,operating,7100000,2,23-08-2013,17-11-2014,6,451,15940,16391
182,operating,2500000,1,17-11-2014,17-11-2014,12,0,16391,16391
183,acquired,51954587,6,09-04-2009,13-11-2014,3,2044,14343,16387
184,operating,10384999,3,22-10-2009,26-02-2013,1,1223,14539,15762
185,operating,,1,13-07-2011,13-07-2011,1,0,15168,15168
186,operating,40000,1,11-03-2013,11-03-2013,1,0,15775,15775
187,operating,1320000,1,01-02-2006,01-02-2006,1,0,13180,13180
188,operating,1000000,3,01-02-2014,25-01-2015,2,358,16102,16460
189,closed,767000,1,01-08-2006,01-08-2006,3,0,13361,13361
190,operating,7000000,3,17-07-2012,24-03-2015,5,980,15538,16518
191,acquired,1500000,2,15-03-2014,27-04-2014,1,43,16144,16187
192,operating,,1,01-06-2014,01-06-2014,2,0,16222,16222
193,acquired,35301007,5,23-01-2007,25-03-2011,8,1522,13536,15058
194,operating,350000,1,01-04-2008,01-04-2008,2,0,13970,13970
195,operating,2930000,1,23-07-2009,23-07-2009,1,0,14448,14448
196,operating,291841,2,10-11-2014,14-09-2015,3,308,16384,16692
197,operating,8000000,2,18-11-2009,01-03-2010,6,103,14566,14669
198,operating,6700000,3,10-05-2013,20-12-2013,1,224,15835,16059
199,operating,15125297,4,30-07-2012,16-10-2015,4,1173,15551,16724
200,operating,1810000,2,10-04-2013,28-01-2014,5,293,15805,16098
201,operating,5828444,6,14-10-2011,27-03-2014,6,895,15261,16156
202,ipo,180500000,6,18-04-2007,31-03-2015,16,2904,13621,16525
203,operating,,1,10-05-2014,10-05-2014,1,0,16200,16200
204,operating,,1,15-12-2013,15-12-2013,1,0,16054,16054
205,operating,,1,25-11-2013,25-11-2013,1,0,16034,16034
206,acquired,1000000,1,01-12-2007,01-12-2007,1,0,13848,13848
207,operating,,1,01-01-2011,01-01-2011,1,0,14975,14975
208,operating,850000,2,01-05-2007,01-09-2008,2,489,13634,14123
209,operating,17800000,1,11-08-2014,11-08-2014,3,0,16293,16293
210,operating,17880000,1,18-09-2006,18-09-2006,2,0,13409,13409
211,closed,4000000,1,14-11-2006,14-11-2006,3,0,13466,13466
212,operating,,1,15-10-2013,15-10-2013,2,0,15993,15993
213,operating,600000,2,01-09-2012,01-11-2012,2,61,15584,15645
214,closed,15000000,1,10-01-2007,10-01-2007,1,0,13523,13523
215,operating,196615,1,05-11-2014,05-11-2014,1,0,16379,16379
216,operating,7410000,3,06-11-2012,06-12-2013,9,395,15650,16045
217,operating,10000000,1,31-01-2014,31-01-2014,1,0,16101,16101
218,operating,150000,2,12-06-2013,25-07-2013,2,43,15868,15911
219,acquired,37300000,4,21-02-2007,17-10-2013,8,2430,13565,15995
220,operating,3733834,1,22-06-2001,22-06-2001,1,0,11495,11495
221,operating,1500000,1,23-02-2014,23-02-2014,2,0,16124,16124
222,operating,1500000,4,10-10-2012,11-04-2014,4,548,15623,16171
223,operating,1150000,2,29-10-2013,10-02-2015,3,469,16007,16476
224,operating,175000,2,20-02-2014,18-06-2014,1,118,16121,16239
225,operating,1098478,1,09-06-2014,09-06-2014,2,0,16230,16230
226,operating,,1,01-09-2012,01-09-2012,1,0,15584,15584
227,operating,3590727,3,15-12-2009,20-05-2011,2,521,14593,15114
228,operating,125000,2,15-05-2010,05-05-2011,2,355,14744,15099
229,closed,18710,1,28-11-2014,28-11-2014,1,0,16402,16402
230,acquired,8000000,1,10-11-2004,10-11-2004,2,0,12732,12732
231,operating,57076,1,01-01-2014,01-01-2014,1,0,16071,16071
232,operating,18300000,1,12-03-2015,12-03-2015,2,0,16506,16506
233,operating,10000000,1,23-03-2015,23-03-2015,1,0,16517,16517
234,operating,,1,01-01-2014,01-01-2014,2,0,16071,16071
235,closed,42352200,1,03-09-2010,03-09-2010,2,0,14855,14855
236,operating,1365100,1,13-08-2007,13-08-2007,1,0,13738,13738
237,operating,240000,2,30-04-2002,01-01-2006,2,1342,11807,13149
238,operating,8000000,1,17-02-2015,17-02-2015,3,0,16483,16483
239,operating,,1,21-11-2013,21-11-2013,1,0,16030,16030
240,operating,264713,1,24-08-2012,24-08-2012,1,0,15576,15576
241,operating,10000000,2,22-07-2010,25-10-2010,3,95,14812,14907
242,operating,,1,10-01-2014,10-01-2014,1,0,16080,16080
243,operating,350000,3,22-05-2012,25-06-2013,2,399,15482,15881
244,operating,16227,1,31-03-2015,31-03-2015,1,0,16525,16525
245,operating,2240532,4,15-03-2013,14-05-2015,5,790,15779,16569
246,operating,27800000,2,28-10-2009,21-07-2011,3,631,14545,15176
247,operating,,1,18-08-2015,18-08-2015,3,0,16665,16665
248,operating,4500000,1,19-09-2005,19-09-2005,3,0,13045,13045
249,operating,2050000,2,30-06-2013,07-04-2015,1,646,15886,16532
250,acquired,1583500,4,29-07-2013,16-07-2015,4,717,15915,16632
251,operating,46000,3,01-02-2011,01-09-2012,2,578,15006,15584
252,operating,206325,2,01-09-2012,01-06-2013,2,273,15584,15857
253,operating,,1,04-01-2012,04-01-2012,1,0,15343,15343
254,acquired,700000,1,12-02-2013,12-02-2013,5,0,15748,15748
255,closed,15000,2,01-08-2013,20-02-2014,2,203,15918,16121
256,operating,2000000,1,02-04-2014,02-04-2014,2,0,16162,16162
257,operating,1500000,1,25-06-2006,25-06-2006,3,0,13324,13324
258,operating,44645,1,22-08-2013,22-08-2013,2,0,15939,15939
259,operating,31205,1,13-08-2015,13-08-2015,1,0,16660,16660
260,operating,12500000,2,11-03-2013,16-12-2013,2,280,15775,16055
261,operating,,1,23-12-2014,23-12-2014,1,0,16427,16427
262,acquired,15000000,1,19-05-2004,19-05-2004,5,0,12557,12557
263,operating,120000,1,16-07-2014,16-07-2014,1,0,16267,16267
264,operating,900000,1,23-09-2014,23-09-2014,9,0,16336,16336
265,operating,5000000,2,01-10-2007,03-04-2008,2,185,13787,13972
266,operating,16700000,1,07-09-2015,07-09-2015,4,0,16685,16685
267,operating,,1,01-03-2006,01-03-2006,1,0,13208,13208
268,ipo,20729000,7,01-05-2002,13-11-2013,11,4214,11808,16022
269,operating,10000000,1,01-10-2012,01-10-2012,1,0,15614,15614
270,operating,50000,3,13-09-2013,01-05-2014,23,230,15961,16191
271,acquired,,1,01-09-2013,01-09-2013,1,0,15949,15949
272,acquired,3000000,1,17-05-2007,17-05-2007,3,0,13650,13650
273,operating,27030000,6,01-03-2010,13-07-2015,17,1960,14669,16629
274,operating,312004,3,01-02-2011,10-03-2012,2,403,15006,15409
275,closed,52792,1,01-05-2013,01-05-2013,1,0,15826,15826
276,operating,,2,01-06-2011,01-03-2012,2,274,15126,15400
277,operating,730000,4,28-10-2010,01-12-2011,13,399,14910,15309
278,operating,3000,1,01-02-2012,01-02-2012,2,0,15371,15371
279,operating,,1,01-10-2015,01-10-2015,1,0,16709,16709
280,operating,18745880,4,30-09-2008,03-04-2015,3,2376,14152,16528
281,operating,,2,02-09-2013,01-01-2015,4,486,15950,16436
282,closed,11885330.33,1,28-02-2006,28-02-2006,3,0,13207,13207
283,operating,420000,2,01-03-2011,16-06-2011,7,107,15034,15141
284,operating,20352,1,21-07-2014,21-07-2014,1,0,16272,16272
285,operating,114500000,2,06-05-2010,26-02-2013,7,1027,14735,15762
286,acquired,358969,2,01-08-2010,10-05-2011,1,282,14822,15104
287,operating,35000000,2,22-04-2014,17-02-2015,4,301,16182,16483
288,operating,41250,1,01-12-2014,01-12-2014,1,0,16405,16405
289,acquired,28400000,4,13-10-1999,01-01-2006,12,2272,10877,13149
290,operating,265064,1,11-06-2013,11-06-2013,1,0,15867,15867
291,operating,25000000,1,11-01-2012,11-01-2012,1,0,15350,15350
292,acquired,,1,30-10-2008,30-10-2008,4,0,14182,14182
293,acquired,,1,14-01-1999,14-01-1999,1,0,10605,10605
294,closed,13800000,2,24-10-2000,18-03-2003,7,875,11254,12129
295,operating,700000,1,18-08-2015,18-08-2015,1,0,16665,16665
296,acquired,339000,1,02-10-2006,02-10-2006,2,0,13423,13423
297,operating,,1,01-09-2011,01-09-2011,1,0,15218,15218
298,operating,20000000,3,16-10-2013,19-05-2015,7,580,15994,16574
299,operating,,1,02-04-2014,02-04-2014,1,0,16162,16162
300,operating,1802640,2,03-05-2013,27-08-2014,1,481,15828,16309
301,operating,1359471,1,14-08-2014,14-08-2014,1,0,16296,16296
302,operating,2453923,1,11-03-2002,11-03-2002,2,0,11757,11757
303,acquired,,1,01-01-2013,01-01-2013,1,0,15706,15706
304,operating,150000,1,01-07-2008,01-07-2008,1,0,14061,14061
305,acquired,20000000,1,10-11-2003,10-11-2003,5,0,12366,12366
306,operating,2000000,1,31-03-2013,31-03-2013,1,0,15795,15795
307,operating,,1,20-02-2013,20-02-2013,1,0,15756,15756
308,operating,,1,13-04-2013,13-04-2013,1,0,15808,15808
309,operating,7000000,2,20-12-2010,26-06-2012,5,554,14963,15517
310,acquired,10000000,1,04-02-2002,04-02-2002,2,0,11722,11722
311,operating,8000000,3,12-12-2012,11-02-2015,4,791,15686,16477
312,closed,41000000,2,12-11-2015,12-11-2015,3,0,16751,16751
313,operating,30449358,3,04-09-2012,26-01-2015,6,874,15587,16461
314,acquired,1550000,2,25-08-2008,13-05-2009,1,261,14116,14377
315,operating,,1,22-11-2011,22-11-2011,1,0,15300,15300
316,operating,,1,09-06-2014,09-06-2014,1,0,16230,16230
317,operating,,1,09-01-2012,09-01-2012,1,0,15348,15348
318,operating,1000000,1,08-07-2012,08-07-2012,4,0,15529,15529
319,operating,211435,2,10-07-2014,01-04-2015,4,265,16261,16526
320,operating,34000000,1,29-09-2014,29-09-2014,1,0,16342,16342
321,operating,13956072,4,30-08-2011,16-03-2015,2,1294,15216,16510
322,operating,3000000,2,14-01-2010,10-02-2011,1,392,14623,15015
323,acquired,36781282,2,11-06-2009,08-10-2010,8,484,14406,14890
324,operating,2070000,4,01-12-2013,10-08-2015,10,617,16040,16657
325,operating,1052000,2,02-04-2005,06-02-2008,2,1040,12875,13915
326,operating,1600000,2,01-12-2012,10-11-2013,6,344,15675,16019
327,closed,18916000,3,01-01-2007,20-08-2009,2,962,13514,14476
328,operating,26226850,3,20-09-2012,02-12-2014,10,803,15603,16406
329,operating,9680000,2,08-07-2005,23-07-2007,7,745,12972,13717
330,operating,982000,2,22-09-2008,05-01-2010,2,470,14144,14614
331,ipo,276760000,7,01-09-2005,01-10-2013,6,2952,13027,15979
332,operating,11000000,2,15-10-2015,03-11-2015,2,19,16723,16742
333,operating,,3,01-01-2012,28-03-2014,3,817,15340,16157
334,closed,285000,1,01-01-2013,01-01-2013,1,0,15706,15706
335,operating,120000,1,16-07-2014,16-07-2014,1,0,16267,16267
336,operating,,1,22-08-2013,22-08-2013,2,0,15939,15939
337,operating,1844725.367,2,02-09-2014,30-04-2015,2,240,16315,16555
338,operating,9750000,2,18-10-2007,20-02-2009,3,491,13804,14295
339,operating,3000000,1,25-06-2015,25-06-2015,1,0,16611,16611
340,acquired,5717561,5,01-07-2004,04-09-2013,3,3352,12600,15952
341,closed,,1,01-06-2012,01-06-2012,1,0,15492,15492
342,operating,1900000,2,01-01-2013,28-01-2015,6,757,15706,16463
343,operating,,1,28-09-2009,28-09-2009,1,0,14515,14515
344,operating,15152514,1,25-03-2014,25-03-2014,1,0,16154,16154
345,acquired,960000,2,17-05-2011,06-08-2012,11,447,15111,15558
346,operating,14000000,2,01-09-2011,07-10-2014,1,1132,15218,16350
347,operating,,1,17-07-2015,17-07-2015,1,0,16633,16633
348,operating,14253858,4,01-01-2013,07-10-2015,1,1009,15706,16715
349,operating,3347305.389,2,28-08-2013,02-09-2015,5,735,15945,16680
350,operating,139411,1,28-04-2008,28-04-2008,1,0,13997,13997
351,operating,1208791,1,29-04-2015,29-04-2015,1,0,16554,16554
352,operating,9800000,1,07-04-2015,07-04-2015,4,0,16532,16532
353,operating,,1,07-03-2012,07-03-2012,1,0,15406,15406
354,operating,14500000,1,13-10-2015,13-10-2015,2,0,16721,16721
355,operating,,1,01-09-2014,01-09-2014,1,0,16314,16314
356,closed,701760,1,12-06-2009,12-06-2009,1,0,14407,14407
357,acquired,7015000,3,19-08-2009,08-03-2011,15,566,14475,15041
358,closed,300000,2,01-06-2014,17-07-2015,7,411,16222,16633
359,operating,17647446,2,01-01-2014,28-01-2015,1,392,16071,16463
360,operating,1000000,1,27-04-2015,27-04-2015,2,0,16552,16552
361,operating,,1,18-08-2012,18-08-2012,1,0,15570,15570
362,closed,135000,1,13-03-2012,13-03-2012,1,0,15412,15412
363,operating,20700000,3,07-12-2005,13-04-2009,9,1223,13124,14347
364,operating,500000,2,31-08-2012,03-01-2014,20,490,15583,16073
365,operating,7342309,1,01-08-2011,01-08-2011,1,0,15187,15187
366,operating,41250,1,01-01-2014,01-01-2014,1,0,16071,16071
367,operating,1287500,1,20-11-2007,20-11-2007,1,0,13837,13837
368,operating,,1,20-12-2013,20-12-2013,1,0,16059,16059
369,operating,2800000,1,01-03-2011,01-03-2011,6,0,15034,15034
370,acquired,6000000,1,04-03-2003,04-03-2003,4,0,12115,12115
371,operating,416694,1,02-02-2014,02-02-2014,2,0,16103,16103
372,acquired,15000000,2,01-12-2008,19-08-2010,4,626,14214,14840
373,operating,1755027,1,12-11-2015,12-11-2015,2,0,16751,16751
374,operating,390360,1,06-01-2013,06-01-2013,1,0,15711,15711
375,acquired,1500000,1,01-07-2010,01-07-2010,1,0,14791,14791
376,operating,1381877,1,24-04-2014,24-04-2014,10,0,16184,16184
377,operating,473326,1,05-10-2014,05-10-2014,2,0,16348,16348
378,operating,725000,3,10-12-2013,10-11-2014,1,335,16049,16384
379,operating,158567,1,01-03-2008,01-03-2008,2,0,13939,13939
380,operating,10000000,1,10-03-2015,10-03-2015,3,0,16504,16504
381,operating,1000000,1,10-03-2013,10-03-2013,1,0,15774,15774
382,operating,4815000,2,13-01-2011,25-03-2011,2,71,14987,15058
383,operating,2000000,1,09-07-2015,09-07-2015,4,0,16625,16625
384,operating,4445000,5,30-11-2012,30-10-2015,4,1064,15674,16738
385,operating,5000000,2,01-06-2013,12-09-2014,2,468,15857,16325
386,operating,,1,30-04-2015,30-04-2015,3,0,16555,16555
387,acquired,66300000,6,01-09-2000,14-12-2009,11,3391,11201,14592
388,operating,,1,01-01-2006,01-01-2006,1,0,13149,13149
389,operating,,1,03-09-2013,03-09-2013,1,0,15951,15951
390,operating,3650000,3,13-10-2013,16-07-2015,14,641,15991,16632
391,operating,19299,1,14-10-2013,14-10-2013,1,0,15992,15992
392,operating,5400000,6,01-09-2012,17-07-2014,17,684,15584,16268
393,acquired,6500000,1,15-02-2005,15-02-2005,2,0,12829,12829
394,operating,150000,1,01-12-2012,01-12-2012,1,0,15675,15675
395,operating,2100000,1,30-04-2007,30-04-2007,3,0,13633,13633
396,operating,,1,21-05-2013,21-05-2013,1,0,15846,15846
397,acquired,10381850,2,19-11-2013,13-02-2015,4,451,16028,16479
398,acquired,35860000,3,31-03-2003,06-09-2007,8,1620,12142,13762
399,operating,9837165,2,04-06-2014,25-06-2015,7,386,16225,16611
400,operating,,2,01-01-2006,01-07-2012,3,2373,13149,15522
401,operating,40000000,1,01-02-2000,01-02-2000,2,0,10988,10988
402,operating,6950000,2,01-03-2007,10-06-2008,2,467,13573,14040
403,acquired,27400000,2,29-05-2003,14-07-2005,10,777,12201,12978
404,operating,38000000,1,15-09-2014,15-09-2014,7,0,16328,16328
405,operating,,1,20-08-2015,20-08-2015,1,0,16667,16667
406,operating,40000,1,15-11-2012,15-11-2012,1,0,15659,15659
407,acquired,42000000,1,06-08-2007,06-08-2007,1,0,13731,13731
408,operating,2600000,1,14-07-2015,14-07-2015,8,0,16630,16630
409,operating,,1,22-08-2007,22-08-2007,2,0,13747,13747
410,operating,88900000,5,27-04-2011,19-08-2015,18,1575,15091,16666
411,operating,30000,1,01-02-2015,01-02-2015,1,0,16467,16467
412,operating,,2,01-11-2007,01-01-2011,1,1157,13818,14975
413,operating,,1,01-08-2012,01-08-2012,1,0,15553,15553
414,operating,565000,3,01-11-2013,01-07-2015,1,607,16010,16617
415,operating,,1,01-03-2015,01-03-2015,1,0,16495,16495
416,operating,1500000,1,19-08-2015,19-08-2015,1,0,16666,16666
417,operating,,1,20-02-2014,20-02-2014,3,0,16121,16121
418,acquired,37500000,2,04-01-2011,20-03-2013,2,806,14978,15784
419,operating,8000000,1,29-09-2003,29-09-2003,2,0,12324,12324
420,acquired,,1,06-01-2012,06-01-2012,1,0,15345,15345
421,operating,3367250,1,25-01-2013,25-01-2013,1,0,15730,15730
422,operating,10000000,1,10-01-2002,10-01-2002,1,0,11697,11697
423,operating,13780000,1,20-05-2009,20-05-2009,1,0,14384,14384
424,operating,9742335.522,1,16-11-2015,16-11-2015,1,0,16755,16755
425,operating,569413,1,18-02-2015,18-02-2015,2,0,16484,16484
426,operating,1198810,2,01-12-2009,03-02-2012,1,794,14579,15373
427,operating,450000,2,27-10-2011,16-12-2011,2,50,15274,15324
428,operating,2238677,4,01-12-2011,15-01-2013,3,411,15309,15720
429,operating,595504,4,01-02-2014,22-09-2015,1,598,16102,16700
430,acquired,6000000,1,27-06-2003,27-06-2003,2,0,12230,12230
431,operating,,2,01-01-2009,01-01-2010,1,365,14245,14610
432,acquired,41600000,4,01-07-2010,20-04-2015,3,1754,14791,16545
433,operating,52120000,6,16-01-2005,11-06-2015,19,3798,12799,16597
434,operating,,1,01-11-2014,01-11-2014,1,0,16375,16375
435,closed,1200000,5,08-09-2006,15-01-2009,9,860,13399,14259
436,operating,2200000,1,29-04-2015,29-04-2015,2,0,16554,16554
437,acquired,80600000,3,27-10-2009,06-03-2013,15,1226,14544,15770
438,operating,3416466,1,28-04-2014,28-04-2014,1,0,16188,16188
439,acquired,,1,01-04-2012,01-04-2012,1,0,15431,15431
440,operating,12000000,1,02-11-1999,02-11-1999,1,0,10897,10897
441,operating,,1,12-04-2014,12-04-2014,1,0,16172,16172
442,operating,270820,1,13-06-2014,13-06-2014,1,0,16234,16234
443,operating,10998000,4,03-06-2013,03-12-2015,5,913,15859,16772
444,operating,6800000,4,01-03-2011,18-03-2015,19,1478,15034,16512
445,operating,,1,30-04-2015,30-04-2015,1,0,16555,16555
446,operating,750000,1,17-01-2012,17-01-2012,3,0,15356,15356
447,operating,16773,1,25-09-2015,25-09-2015,1,0,16703,16703
448,operating,,1,01-11-2013,01-11-2013,2,0,16010,16010
449,operating,404000,4,01-06-2012,07-01-2014,6,585,15492,16077
450,operating,2500000,2,18-05-2010,14-11-2011,1,545,14747,15292
451,operating,800000,1,24-05-2010,24-05-2010,4,0,14753,14753
452,acquired,61000000,2,07-03-2003,16-03-2005,5,740,12118,12858
453,operating,50000,1,18-06-2015,18-06-2015,1,0,16604,16604
454,acquired,5628800,1,27-01-2010,27-01-2010,3,0,14636,14636
455,ipo,110800000,6,01-11-2006,07-07-2012,16,2075,13453,15528
456,acquired,200000,1,28-08-2014,28-08-2014,2,0,16310,16310
457,operating,51000000,2,01-01-2007,12-03-2009,5,801,13514,14315
458,operating,7000000,3,30-06-2013,14-07-2015,11,744,15886,16630
459,operating,11250000,2,08-09-2010,04-11-2014,5,1518,14860,16378
460,operating,2300000,1,29-07-2014,29-07-2014,5,0,16280,16280
461,closed,,1,01-01-2012,01-01-2012,1,0,15340,15340
462,operating,2000000,2,09-07-2014,05-09-2014,5,58,16260,16318
463,acquired,23400000,4,01-01-2009,18-01-2012,15,1112,14245,15357
464,operating,33793,1,01-10-2013,01-10-2013,1,0,15979,15979
465,operating,30000000,1,06-09-2013,06-09-2013,1,0,15954,15954
466,operating,600000,1,05-08-2013,05-08-2013,1,0,15922,15922
467,operating,5300000,5,02-05-2006,05-05-2014,4,2925,13270,16195
468,operating,1225000,4,03-07-2012,01-01-2014,6,547,15524,16071
469,operating,97000000,5,01-01-2008,24-10-2013,18,2123,13879,16002
470,operating,40000000,5,01-04-2008,01-04-2013,6,1826,13970,15796
471,operating,10000000,1,18-06-2014,18-06-2014,1,0,16239,16239
472,operating,118000,1,06-07-2015,06-07-2015,1,0,16622,16622
473,operating,10400000,5,17-03-2005,16-08-2011,15,2343,12859,15202
474,operating,2000000,1,01-04-2015,01-04-2015,2,0,16526,16526
475,operating,,2,01-12-2014,13-04-2015,2,133,16405,16538
476,operating,,1,01-01-2013,01-01-2013,1,0,15706,15706
477,operating,5000000,1,01-03-2009,01-03-2009,1,0,14304,14304
478,operating,,2,01-01-2006,31-12-2011,2,2190,13149,15339
479,operating,625000,2,01-12-2013,06-08-2014,2,248,16040,16288
480,operating,70000,2,29-10-2013,05-08-2014,1,280,16007,16287
481,operating,16000000,1,11-06-2015,11-06-2015,1,0,16597,16597
482,closed,25000,1,05-09-2011,05-09-2011,1,0,15222,15222
483,operating,1540943,2,23-05-2012,18-11-2013,5,544,15483,16027
484,closed,,1,01-06-2015,01-06-2015,1,0,16587,16587
485,operating,49761910,10,01-11-2006,15-01-2014,4,2632,13453,16085
486,operating,20000,1,04-01-2013,04-01-2013,1,0,15709,15709
487,operating,700000,1,26-02-2015,26-02-2015,3,0,16492,16492
488,operating,4364112,2,21-10-2013,27-03-2015,4,522,15999,16521
489,operating,,3,01-01-2014,15-10-2015,3,652,16071,16723
490,operating,8100000,2,01-03-2013,08-12-2014,3,647,15765,16412
491,acquired,13708764,2,01-02-2000,10-03-2004,2,1499,10988,12487
492,operating,500000,1,01-03-2013,01-03-2013,1,0,15765,15765
493,closed,,1,01-05-2015,01-05-2015,1,0,16556,16556
494,operating,,1,13-02-2009,13-02-2009,1,0,14288,14288
495,operating,110878477,2,01-01-2010,28-02-2014,3,1519,14610,16129
496,operating,,1,04-04-2012,04-04-2012,1,0,15434,15434
497,operating,,1,01-06-2013,01-06-2013,1,0,15857,15857
498,operating,10000000,1,01-01-2008,01-01-2008,1,0,13879,13879
499,operating,,5,01-03-2013,17-06-2015,5,838,15765,16603
500,operating,,1,01-06-2012,01-06-2012,1,0,15492,15492
501,operating,67022,1,01-08-2014,01-08-2014,1,0,16283,16283
502,acquired,,1,18-10-2007,18-10-2007,1,0,13804,13804
503,operating,,1,12-05-2015,12-05-2015,1,0,16567,16567
504,operating,35371,1,05-09-2011,05-09-2011,1,0,15222,15222
505,operating,70200000,5,01-02-2008,03-04-2015,12,2618,13910,16528
506,operating,40000,1,01-07-2013,01-07-2013,1,0,15887,15887
507,operating,,1,12-04-2013,12-04-2013,1,0,15807,15807
508,operating,20000000,3,10-04-2012,02-10-2013,7,540,15440,15980
509,operating,24000,1,11-08-2012,11-08-2012,1,0,15563,15563
510,operating,50000,1,01-01-2011,01-01-2011,2,0,14975,14975
511,operating,75000,3,26-10-2011,23-10-2014,2,1093,15273,16366
512,operating,11000000,1,08-09-2014,08-09-2014,2,0,16321,16321
513,operating,377200,1,19-09-2014,19-09-2014,1,0,16332,16332
514,operating,1900000,1,01-01-2012,01-01-2012,1,0,15340,15340
515,closed,,1,01-10-2013,01-10-2013,11,0,15979,15979
516,operating,12731053,4,17-06-2010,17-07-2014,6,1491,14777,16268
517,acquired,27000000,3,19-12-2006,27-05-2009,1,890,13501,14391
518,operating,3000000,1,13-10-2011,13-10-2011,7,0,15260,15260
519,operating,20200000,2,01-07-2007,03-01-2008,3,186,13695,13881
520,operating,4304503,4,28-11-2011,18-12-2014,9,1116,15306,16422
521,operating,15000,1,01-06-2012,01-06-2012,1,0,15492,15492
522,operating,12000000,1,21-10-2010,21-10-2010,1,0,14903,14903
523,operating,40000,1,23-08-2013,23-08-2013,1,0,15940,15940
524,operating,2247131,2,22-05-2013,08-05-2015,3,716,15847,16563
525,operating,,1,30-04-2015,30-04-2015,1,0,16555,16555
526,operating,717699,2,08-04-2011,27-08-2012,6,507,15072,15579
527,operating,14253000,2,28-01-2002,19-12-2012,4,3978,11715,15693
528,acquired,1200000,1,01-02-2011,01-02-2011,11,0,15006,15006
529,operating,2130000,2,01-06-2015,04-11-2015,7,156,16587,16743
530,operating,12000000,1,18-05-2011,18-05-2011,1,0,15112,15112
531,operating,3800000,1,26-02-2015,26-02-2015,8,0,16492,16492
532,operating,273453,1,01-07-2014,01-07-2014,1,0,16252,16252
533,acquired,25000000,1,15-10-2007,15-10-2007,3,0,13801,13801
534,operating,325000,2,26-07-2013,01-09-2013,2,37,15912,15949
535,operating,389790,1,11-12-2012,11-12-2012,2,0,15685,15685
536,ipo,83700000,2,30-11-2009,10-09-2010,1,284,14578,14862
537,operating,,1,03-12-2014,03-12-2014,1,0,16407,16407
538,operating,,1,29-05-2013,29-05-2013,2,0,15854,15854
539,operating,1300000,1,01-12-2012,01-12-2012,1,0,15675,15675
540,operating,1000000,2,24-04-2013,22-07-2014,2,454,15819,16273
541,operating,77000000,3,19-10-2011,03-03-2015,13,1231,15266,16497
542,operating,,1,01-03-2010,01-03-2010,1,0,14669,14669
543,acquired,11000000,2,11-02-2004,31-03-2006,6,779,12459,13238
544,operating,4050000,4,11-01-2013,14-01-2015,4,733,15716,16449
545,closed,550000,2,09-02-2008,27-01-2009,21,353,13918,14271
546,closed,7600000,1,26-05-2008,26-05-2008,3,0,14025,14025
547,operating,21000000,2,01-04-2014,18-09-2014,3,170,16161,16331
548,operating,803909,2,01-05-2009,01-06-2012,1,1127,14365,15492
549,acquired,8000000,1,17-01-2006,17-01-2006,4,0,13165,13165
550,closed,800000,1,01-12-2006,01-12-2006,3,0,13483,13483
551,operating,37000000,3,17-08-2005,12-03-2009,10,1303,13012,14315
552,operating,,1,01-09-2008,01-09-2008,1,0,14123,14123
553,operating,110000000,1,15-01-2002,15-01-2002,1,0,11702,11702
554,ipo,45214105,3,31-01-2008,21-07-2009,5,537,13909,14446
555,closed,44000000,3,24-01-2006,13-09-2010,9,1693,13172,14865
556,operating,7000000,1,06-12-2005,06-12-2005,3,0,13123,13123
557,operating,15800000,1,25-06-2007,25-06-2007,3,0,13689,13689
558,operating,25000000,1,14-12-2014,14-12-2014,1,0,16418,16418
559,ipo,,1,29-08-2001,29-08-2001,1,0,11563,11563
560,operating,15931,1,11-04-2015,11-04-2015,1,0,16536,16536
561,operating,,1,16-12-2014,16-12-2014,1,0,16420,16420
562,operating,4750000,4,08-10-2013,01-08-2015,6,662,15986,16648
563,operating,10250000,5,01-03-2013,01-06-2015,26,822,15765,16587
564,operating,15000,1,07-08-2013,07-08-2013,2,0,15924,15924
565,operating,23728080,5,08-05-2006,07-09-2010,13,1583,13276,14859
566,operating,2100000,2,01-01-2011,08-07-2013,4,919,14975,15894
567,operating,,1,19-07-2013,19-07-2013,1,0,15905,15905
568,operating,100000,1,18-03-2015,18-03-2015,1,0,16512,16512
569,operating,10500000,5,26-03-2012,27-10-2015,6,1310,15425,16735
570,closed,3500000,2,01-11-2010,11-11-2015,2,1836,14914,16750
571,ipo,180500000,5,01-12-1996,01-02-2010,7,4810,9831,14641
572,operating,,1,28-01-2015,28-01-2015,2,0,16463,16463
573,operating,1570000,3,01-01-2013,20-05-2014,3,504,15706,16210
574,operating,4500000,1,30-07-2014,30-07-2014,3,0,16281,16281
575,acquired,29000000,2,18-09-2006,04-02-2008,5,504,13409,13913
576,closed,83257446,4,01-06-2004,16-08-2010,14,2267,12570,14837
577,operating,324713,2,04-04-2012,31-08-2012,1,149,15434,15583
578,closed,250000,1,01-01-2013,01-01-2013,1,0,15706,15706
579,operating,,1,17-12-2004,17-12-2004,1,0,12769,12769
580,operating,145740,4,22-08-2012,01-05-2014,4,617,15574,16191
581,operating,32680,1,01-05-2013,01-05-2013,1,0,15826,15826
582,operating,1100000,1,03-11-2010,03-11-2010,1,0,14916,14916
583,operating,,1,21-02-2012,21-02-2012,2,0,15391,15391
584,operating,10600000,1,11-09-2014,11-09-2014,1,0,16324,16324
585,ipo,50000000,1,30-06-2008,30-06-2008,3,0,14060,14060
586,operating,13001842,4,01-02-2013,03-12-2014,4,670,15737,16407
587,operating,3413540,2,07-05-2009,17-04-2013,4,1441,14371,15812
588,acquired,30000000,2,01-06-2007,01-12-2007,8,183,13665,13848
589,operating,600000,3,01-01-2010,01-05-2014,2,1581,14610,16191
590,closed,1000000,1,01-01-2000,01-01-2000,1,0,10957,10957
591,closed,,1,01-03-2012,01-03-2012,2,0,15400,15400
592,operating,550000,1,04-07-2011,04-07-2011,2,0,15159,15159
593,operating,1929900,2,01-01-2010,27-06-2013,3,1273,14610,15883
594,operating,8080000,2,16-08-2005,01-06-2007,15,654,13011,13665
595,acquired,1900000,1,01-05-2005,01-05-2005,3,0,12904,12904
596,closed,,1,01-03-2012,01-03-2012,1,0,15400,15400
597,operating,1700000,2,01-11-2011,09-10-2013,7,708,15279,15987
598,operating,250000,1,10-05-2012,10-05-2012,1,0,15470,15470
599,acquired,,2,26-07-2011,14-02-2012,2,203,15181,15384
600,operating,,1,23-01-2013,23-01-2013,1,0,15728,15728
601,operating,5260821,5,22-02-2007,28-01-2015,10,2897,13566,16463
602,operating,13000000,1,04-10-2006,04-10-2006,1,0,13425,13425
603,operating,,1,01-10-2001,01-10-2001,1,0,11596,11596
604,operating,156828,1,01-12-2014,01-12-2014,1,0,16405,16405
605,operating,2000000,2,01-01-2007,16-07-2009,4,927,13514,14441
606,operating,,1,01-04-2014,01-04-2014,1,0,16161,16161
607,closed,173433,1,01-01-2015,01-01-2015,1,0,16436,16436
608,operating,24000000,2,19-12-2013,13-08-2015,1,602,16058,16660
609,operating,200000,3,02-08-2009,07-11-2013,1,1558,14458,16016
610,closed,,1,01-06-2015,01-06-2015,1,0,16587,16587
611,operating,,1,01-05-2014,01-05-2014,1,0,16191,16191
612,operating,,1,05-02-2014,05-02-2014,2,0,16106,16106
613,acquired,94600000,4,15-12-2003,10-08-2009,13,2065,12401,14466
614,operating,18748565,1,20-12-2011,20-12-2011,3,0,15328,15328
615,ipo,107440000,5,01-01-2002,14-04-2011,11,3390,11688,15078
616,operating,10671168,5,01-04-2008,06-01-2014,5,2106,13970,16076
617,operating,250000,1,31-01-2012,31-01-2012,2,0,15370,15370
618,operating,1185585000,8,01-05-2012,29-05-2015,19,1123,15461,16584
619,operating,,1,03-09-2013,03-09-2013,1,0,15951,15951
620,acquired,89200000,5,16-01-2007,30-11-2011,13,1779,13529,15308
621,operating,50000,1,06-05-2015,06-05-2015,1,0,16561,16561
622,closed,1000000,1,09-06-2005,09-06-2005,3,0,12943,12943
623,acquired,64795,1,01-04-2005,01-04-2005,1,0,12874,12874
624,operating,3300000,3,13-07-2011,07-06-2013,9,695,15168,15863
625,acquired,,1,10-05-2001,10-05-2001,1,0,11452,11452
626,acquired,8200000,2,01-04-2005,21-06-2012,4,2638,12874,15512
627,operating,440000,1,05-09-2005,05-09-2005,1,0,13031,13031
628,operating,25000,1,16-08-2013,16-08-2013,2,0,15933,15933
629,operating,30000000,1,17-11-2003,17-11-2003,6,0,12373,12373
630,operating,550000,1,22-05-2009,22-05-2009,1,0,14386,14386
631,operating,21900000,2,09-11-2014,23-11-2015,2,379,16383,16762
632,operating,,1,01-01-2014,01-01-2014,1,0,16071,16071
633,ipo,92989194,4,01-08-2003,14-03-2011,9,2782,12265,15047
634,operating,,1,01-09-2013,01-09-2013,1,0,15949,15949
635,operating,,1,01-08-2012,01-08-2012,1,0,15553,15553
636,closed,,1,01-08-2012,01-08-2012,1,0,15553,15553
637,ipo,8771500,5,14-08-2013,07-05-2015,3,631,15931,16562
638,closed,12000000,2,01-01-2007,16-09-2008,2,624,13514,14138
639,operating,622858,1,15-12-2014,15-12-2014,1,0,16419,16419
640,operating,2000000,1,06-04-2014,06-04-2014,4,0,16166,16166
641,operating,2723900,2,09-06-2005,04-10-2011,3,2308,12943,15251
642,operating,,1,01-01-2013,01-01-2013,1,0,15706,15706
643,acquired,7000000,1,12-07-2001,12-07-2001,3,0,11515,11515
644,operating,2701849,1,13-10-2014,13-10-2014,4,0,16356,16356
645,operating,5000000,1,22-02-2008,22-02-2008,1,0,13931,13931
646,ipo,56000000,1,11-02-2002,11-02-2002,14,0,11729,11729
647,operating,20000,2,15-02-2012,17-01-2013,2,337,15385,15722
648,operating,3077268,4,01-08-2012,30-12-2014,3,881,15553,16434
649,acquired,4500000,1,13-08-2007,13-08-2007,1,0,13738,13738
650,operating,17000000,2,29-07-2014,15-10-2015,3,443,16280,16723
651,operating,5500000,1,11-02-2005,11-02-2005,6,0,12825,12825
652,operating,2300000,2,23-10-2013,24-11-2014,6,397,16001,16398
653,acquired,,1,05-04-2007,05-04-2007,2,0,13608,13608
654,closed,100000,1,22-07-2010,22-07-2010,3,0,14812,14812
655,operating,13800000,2,04-09-2013,09-04-2015,18,582,15952,16534
656,operating,2300000,1,16-10-2013,16-10-2013,8,0,15994,15994
657,operating,53000000,4,01-01-2012,13-01-2015,6,1108,15340,16448
658,operating,553000,2,01-09-2013,17-06-2014,2,289,15949,16238
659,operating,7500000,1,04-08-2004,04-08-2004,4,0,12634,12634
660,operating,15000000,2,01-02-2011,31-07-2013,5,911,15006,15917
661,operating,26294000,1,20-12-2010,20-12-2010,2,0,14963,14963
662,operating,7217716,2,17-01-2014,01-05-2015,2,469,16087,16556
663,operating,12000000,1,28-03-2014,28-03-2014,1,0,16157,16157
664,operating,27500,1,01-09-2012,01-09-2012,1,0,15584,15584
665,operating,7500000,2,21-08-2007,21-08-2007,1,0,13746,13746
666,operating,6536608,3,01-01-2007,29-03-2010,6,1183,13514,14697
667,operating,5000000,1,19-02-2015,19-02-2015,1,0,16485,16485
668,operating,10000,1,01-07-2013,01-07-2013,1,0,15887,15887
669,operating,900000,2,15-05-2012,22-01-2014,5,617,15475,16092
670,closed,106800000,4,24-06-2004,03-03-2010,19,2078,12593,14671
671,operating,,1,05-02-2013,05-02-2013,1,0,15741,15741
672,operating,,1,01-06-2012,01-06-2012,2,0,15492,15492
673,operating,2000000,1,03-06-2013,03-06-2013,2,0,15859,15859
674,closed,5730000,1,25-09-2009,25-09-2009,3,0,14512,14512
675,operating,20600000,4,30-03-1999,14-05-2012,15,4794,10680,15474
676,operating,16400000,2,27-04-2010,23-01-2015,3,1732,14726,16458
677,operating,19900000,4,01-06-2011,14-07-2015,9,1504,15126,16630
678,acquired,10402868.42,1,08-11-1999,08-11-1999,1,0,10903,10903
679,operating,1300000,1,31-03-2015,31-03-2015,5,0,16525,16525
680,operating,35000000,1,08-09-2014,08-09-2014,1,0,16321,16321
681,operating,750000,2,25-02-2013,10-12-2014,4,653,15761,16414
682,operating,3392314,1,11-06-2014,11-06-2014,2,0,16232,16232
683,closed,,1,01-03-2010,01-03-2010,1,0,14669,14669
684,operating,,1,06-09-2015,06-09-2015,1,0,16684,16684
685,closed,70000,2,15-10-2011,25-03-2013,2,527,15262,15789
686,acquired,1500000,1,16-07-2009,16-07-2009,1,0,14441,14441
687,operating,3800000,1,15-04-2014,15-04-2014,3,0,16175,16175
688,operating,2200000,2,09-04-2015,16-07-2015,7,98,16534,16632
689,closed,,1,06-06-2001,06-06-2001,5,0,11479,11479
690,operating,2250000,2,27-03-2015,31-08-2015,5,157,16521,16678
691,operating,5100000,2,18-10-2013,09-10-2014,1,356,15996,16352
692,operating,1000000,2,01-01-2010,16-06-2015,1,1992,14610,16602
693,closed,,1,04-09-2014,04-09-2014,1,0,16317,16317
694,operating,40000000,1,04-06-2015,04-06-2015,1,0,16590,16590
695,acquired,22000000,1,10-07-2003,10-07-2003,1,0,12243,12243
696,ipo,18139599,5,27-07-2012,24-07-2014,1,727,15548,16275
697,closed,1535000,3,01-05-2014,26-05-2015,24,390,16191,16581
698,operating,10000000,1,09-09-2015,09-09-2015,1,0,16687,16687
699,operating,783603,2,26-07-2010,22-12-2011,3,514,14816,15330
700,operating,1600000,2,22-01-2014,18-06-2015,1,512,16092,16604
701,operating,460222,1,30-01-2013,30-01-2013,1,0,15735,15735
702,operating,3500000,1,21-02-2013,21-02-2013,1,0,15757,15757
703,operating,1182833,2,30-09-2001,10-09-2009,1,2902,11595,14497
704,operating,525000,2,22-07-2014,10-10-2014,2,80,16273,16353
705,operating,48625021,5,15-08-2011,17-08-2015,9,1463,15201,16664
706,acquired,,1,01-10-2013,01-10-2013,1,0,15979,15979
707,operating,1069452.981,1,04-03-2014,04-03-2014,2,0,16133,16133
708,acquired,5038868,4,01-06-2010,12-03-2012,11,650,14761,15411
709,operating,2000000,2,20-01-2010,08-01-2015,1,1814,14629,16443
710,operating,3000000,1,22-10-2013,22-10-2013,1,0,16000,16000
711,operating,51450000,3,06-02-2014,02-12-2015,4,664,16107,16771
712,operating,,1,26-02-2015,26-02-2015,1,0,16492,16492
713,operating,44252,2,03-09-2014,01-04-2015,2,210,16316,16526
714,operating,8660000,4,12-06-2008,19-07-2010,2,767,14042,14809
715,operating,32500000,3,25-01-2012,05-11-2015,12,1380,15364,16744
716,acquired,14820030,2,06-01-2011,02-05-2012,4,482,14980,15462
717,operating,8000000,1,02-02-2014,02-02-2014,3,0,16103,16103
718,closed,73331503,8,30-09-2002,29-09-2011,9,3286,11960,15246
719,operating,48000000,3,06-03-2013,11-03-2015,9,735,15770,16505
720,operating,18600000,3,01-01-2010,08-04-2013,13,1193,14610,15803
721,operating,263734,1,03-11-2014,03-11-2014,1,0,16377,16377
722,operating,40000,1,11-03-2013,11-03-2013,1,0,15775,15775
723,operating,80399977,1,14-01-2014,14-01-2014,1,0,16084,16084
724,operating,90000,2,01-03-2015,01-11-2015,2,245,16495,16740
725,operating,1210000,2,26-06-2015,26-06-2015,2,0,16612,16612
726,operating,5923950,3,01-11-2011,09-04-2014,4,890,15279,16169
727,closed,70000,2,01-03-2013,01-03-2013,3,0,15765,15765
728,closed,60000000,1,13-04-2004,13-04-2004,17,0,12521,12521
729,ipo,823000000,11,01-04-2004,10-10-2012,35,3114,12509,15623
730,operating,,1,01-06-2011,01-06-2011,1,0,15126,15126
731,closed,12050000,2,18-03-2005,01-07-2007,4,835,12860,13695
732,operating,4052993,1,24-09-2002,24-09-2002,1,0,11954,11954
733,operating,9563440,3,01-11-2007,24-06-2009,5,601,13818,14419
734,operating,1000000,1,01-04-2012,01-04-2012,1,0,15431,15431
735,operating,,1,28-07-2014,28-07-2014,1,0,16279,16279
736,operating,,3,01-08-2010,01-08-2012,2,731,14822,15553
737,operating,2060000,2,02-05-2014,30-09-2014,4,151,16192,16343
738,operating,45048169,3,25-05-2012,26-01-2015,3,976,15485,16461
739,operating,300000,1,18-09-2013,18-09-2013,1,0,15966,15966
740,operating,,1,10-12-2010,10-12-2010,1,0,14953,14953
741,operating,200000,1,23-10-2012,23-10-2012,2,0,15636,15636
742,operating,11000000,1,20-06-2005,20-06-2005,4,0,12954,12954
743,operating,,1,20-09-2011,20-09-2011,1,0,15237,15237
744,operating,29300000,4,05-09-2012,06-05-2015,14,973,15588,16561
745,operating,24410000,4,11-08-2012,13-10-2015,10,1158,15563,16721
746,operating,290977.4604,1,01-03-2015,01-03-2015,1,0,16495,16495
747,acquired,200000000,1,15-03-2007,15-03-2007,3,0,13587,13587
748,operating,690000,1,03-12-2008,03-12-2008,1,0,14216,14216
749,closed,,1,02-08-2011,02-08-2011,1,0,15188,15188
750,closed,40000000,1,23-10-2000,23-10-2000,9,0,11253,11253
751,operating,2150000,2,01-03-2013,05-11-2015,2,979,15765,16744
752,operating,100000000,1,05-05-2015,05-05-2015,1,0,16560,16560
753,acquired,1950000,2,01-05-2007,09-06-2009,3,770,13634,14404
754,operating,,1,06-04-2014,06-04-2014,2,0,16166,16166
755,operating,40000,1,22-08-2013,22-08-2013,1,0,15939,15939
756,ipo,73422000,2,02-11-2009,04-01-2012,14,793,14550,15343
757,operating,10500000,1,25-11-2015,25-11-2015,2,0,16764,16764
758,operating,15000,1,01-08-2007,01-08-2007,1,0,13726,13726
759,operating,788821,1,08-04-2014,08-04-2014,1,0,16168,16168
760,acquired,14109347,3,04-12-2006,08-04-2010,11,1221,13486,14707
761,operating,1400500,1,26-12-2008,26-12-2008,1,0,14239,14239
762,operating,700000,1,25-11-2015,25-11-2015,2,0,16764,16764
763,operating,,1,05-01-2015,05-01-2015,2,0,16440,16440
764,operating,,1,15-09-2014,15-09-2014,1,0,16328,16328
765,operating,2809010,1,18-06-2010,18-06-2010,3,0,14778,14778
766,acquired,,1,31-03-1995,31-03-1995,1,0,9220,9220
767,operating,100000,1,20-10-2012,20-10-2012,2,0,15633,15633
768,operating,,1,26-02-2013,26-02-2013,1,0,15762,15762
769,operating,,2,01-07-2007,01-06-2009,2,701,13695,14396
770,operating,,1,15-05-2014,15-05-2014,1,0,16205,16205
771,operating,17952285.06,2,19-09-2007,21-05-2011,5,1340,13775,15115
772,operating,9000000,2,06-09-2002,18-07-2003,6,315,11936,12251
773,operating,714740,1,08-06-2015,08-06-2015,1,0,16594,16594
774,operating,191577006,3,05-03-2012,13-03-2015,4,1103,15404,16507
775,operating,5350000,1,07-04-2015,07-04-2015,4,0,16532,16532
776,acquired,25800000,3,12-02-2002,01-10-2005,11,1327,11730,13057
777,operating,31000000,4,15-11-2012,24-09-2015,10,1043,15659,16702
778,operating,6346881,2,01-10-2014,18-06-2015,5,260,16344,16604
779,acquired,10500000,1,22-11-1999,22-11-1999,3,0,10917,10917
780,acquired,28000000,3,01-12-2006,30-09-2009,8,1034,13483,14517
781,operating,10000000,2,09-02-2015,30-06-2015,10,141,16475,16616
782,operating,25000,1,01-06-2010,01-06-2010,1,0,14761,14761
783,operating,520000,2,13-03-2013,23-09-2013,4,194,15777,15971
784,acquired,66000000,4,01-12-2010,12-09-2013,15,1016,14944,15960
785,operating,11600000,1,14-08-2007,14-08-2007,3,0,13739,13739
786,operating,24661724,4,02-10-2002,19-06-2013,2,3913,11962,15875
787,operating,1971455,2,10-10-2014,12-03-2015,10,153,16353,16506
788,closed,11700,1,29-08-2013,29-08-2013,1,0,15946,15946
789,operating,,1,16-11-2010,16-11-2010,1,0,14929,14929
790,operating,,1,24-07-2014,24-07-2014,3,0,16275,16275
791,operating,500000,2,01-03-2012,01-05-2013,2,426,15400,15826
792,operating,50977,1,19-06-2014,19-06-2014,1,0,16240,16240
793,operating,3540000,1,29-10-2006,29-10-2006,1,0,13450,13450
794,closed,38500000,2,20-01-2004,11-05-2009,11,1938,12437,14375
795,operating,20868675,5,02-08-2012,23-10-2015,3,1177,15554,16731
796,ipo,,2,01-02-2000,01-07-2006,3,2342,10988,13330
797,operating,1200000,1,21-10-2015,21-10-2015,4,0,16729,16729
798,operating,,1,30-09-2002,30-09-2002,1,0,11960,11960
799,operating,383006,1,02-09-2015,02-09-2015,1,0,16680,16680
800,operating,12018047,2,15-02-2008,27-07-2012,7,1624,13924,15548
801,operating,185000000,3,09-07-2007,19-01-2012,16,1655,13703,15358
802,operating,,1,18-04-2014,18-04-2014,1,0,16178,16178
803,closed,155000,1,01-08-2013,01-08-2013,1,0,15918,15918
804,operating,200000,3,07-08-2014,08-07-2015,4,335,16289,16624
805,operating,8147745,1,01-03-2014,01-03-2014,1,0,16130,16130
806,operating,3000000,2,01-12-2013,25-12-2013,2,24,16040,16064
807,operating,2000000,1,14-10-2014,14-10-2014,13,0,16357,16357
808,acquired,675000,2,05-05-2011,12-04-2012,3,343,15099,15442
809,operating,110000000,2,31-01-2000,12-06-2000,5,133,10987,11120
810,closed,34500000,4,01-06-2006,05-03-2009,15,1008,13300,14308
811,operating,85000,2,18-07-2014,12-12-2015,1,512,16269,16781
812,operating,,2,13-09-2012,17-01-2013,14,126,15596,15722
813,ipo,,1,09-03-2004,09-03-2004,1,0,12486,12486
814,acquired,52000000,2,04-12-2003,02-05-2006,11,880,12390,13270
815,closed,1500000,1,31-01-2012,31-01-2012,5,0,15370,15370
816,closed,2393578,1,27-01-2011,27-01-2011,3,0,15001,15001
817,operating,,1,01-07-2011,01-07-2011,1,0,15156,15156
818,operating,104000000,3,08-11-2012,05-06-2014,9,574,15652,16226
819,operating,,1,07-08-2014,07-08-2014,1,0,16289,16289
820,acquired,13800000,2,29-07-2002,09-02-2006,6,1291,11897,13188
821,operating,85523,2,01-01-2010,01-03-2013,2,1155,14610,15765
822,operating,725000,2,01-06-2013,04-09-2013,3,95,15857,15952
823,operating,1500000,1,14-04-2015,14-04-2015,3,0,16539,16539
824,operating,60000000,3,01-05-2013,28-09-2015,10,880,15826,16706
825,acquired,,1,26-01-2014,26-01-2014,1,0,16096,16096
826,acquired,13000000,1,01-01-2012,01-01-2012,3,0,15340,15340
827,acquired,45000000,1,19-10-2005,19-10-2005,6,0,13075,13075
828,operating,530000,2,21-01-2014,27-03-2014,1,65,16091,16156
829,operating,5600000,1,17-04-2015,17-04-2015,4,0,16542,16542
830,operating,843550.4099,1,18-09-2013,18-09-2013,2,0,15966,15966
831,operating,22500000,3,01-01-2011,28-07-2014,5,1304,14975,16279
832,operating,,1,15-04-2014,15-04-2014,1,0,16175,16175
833,operating,6100000,2,26-06-2012,18-06-2013,5,357,15517,15874
834,operating,510000,2,20-08-2014,24-09-2015,1,400,16302,16702
835,operating,3300000,3,18-06-2007,11-10-2010,6,1211,13682,14893
836,operating,10000000,2,01-10-2014,07-05-2015,2,218,16344,16562
837,closed,300000,1,01-06-2015,01-06-2015,1,0,16587,16587
838,operating,83210,2,26-02-2012,01-09-2012,2,188,15396,15584
839,operating,1978262,4,01-11-2011,01-12-2012,1,396,15279,15675
840,operating,1427030,1,13-05-2013,13-05-2013,1,0,15838,15838
841,acquired,7000000,1,20-07-2007,20-07-2007,3,0,13714,13714
842,operating,,1,05-12-2012,05-12-2012,1,0,15679,15679
843,acquired,39664050,2,22-01-2008,20-07-2011,1,1275,13900,15175
844,operating,,1,10-11-2013,10-11-2013,1,0,16019,16019
845,acquired,3350000,4,01-03-2009,07-03-2011,3,736,14304,15040
846,closed,3359105,1,15-05-2014,15-05-2014,1,0,16205,16205
847,operating,50800000,3,02-11-2009,01-09-2011,15,668,14550,15218
848,operating,1307485,2,05-06-2013,01-07-2014,4,391,15861,16252
849,closed,450000,1,02-02-2015,02-02-2015,1,0,16468,16468
850,operating,4200000,1,17-06-2011,17-06-2011,2,0,15142,15142
851,acquired,133314585,4,06-10-2003,10-11-2009,34,2227,12331,14558
852,operating,6900000,3,13-05-2014,25-07-2014,1,73,16203,16276
853,operating,113000000,5,31-08-2010,02-06-2015,24,1736,14852,16588
854,closed,,1,28-05-2013,28-05-2013,2,0,15853,15853
855,closed,2000000,1,02-05-2010,02-05-2010,2,0,14731,14731
856,operating,4447626,2,17-09-2012,27-02-2015,6,893,15600,16493
857,acquired,74341484,6,11-10-2007,19-07-2011,24,1377,13797,15174
858,operating,2000000,2,29-01-2010,18-08-2011,2,566,14638,15204
859,operating,9000000,1,26-08-2002,26-08-2002,4,0,11925,11925
860,operating,762000,1,29-03-2013,29-03-2013,1,0,15793,15793
861,operating,2700000,2,01-03-2004,21-12-2007,4,1390,12478,13868
862,acquired,8000000,2,05-10-2004,16-06-2010,6,2080,12696,14776
863,closed,5540000,2,31-08-2006,23-09-2008,4,754,13391,14145
864,operating,3250000,2,03-02-2009,15-04-2014,4,1897,14278,16175
865,operating,270000000,2,27-04-2012,11-03-2015,2,1048,15457,16505
866,operating,,1,28-02-2015,28-02-2015,1,0,16494,16494
867,acquired,35600000,6,01-07-2004,23-09-2013,14,3371,12600,15971
868,operating,25000000,1,12-02-2015,12-02-2015,3,0,16478,16478
869,operating,74036,3,27-07-2013,03-09-2014,1,403,15913,16316
870,operating,52548106,5,06-08-2007,20-09-2011,9,1506,13731,15237
871,closed,66000000,2,22-01-2007,01-01-2008,4,344,13535,13879
872,operating,8000000,1,04-06-2015,04-06-2015,2,0,16590,16590
873,operating,3050000,2,25-04-2006,16-10-2013,2,2731,13263,15994
874,operating,,1,15-01-2015,15-01-2015,1,0,16450,16450
875,operating,21000000,2,12-06-2006,28-03-2014,7,2846,13311,16157
876,closed,,2,06-07-2011,12-09-2011,2,68,15161,15229
877,operating,120000,1,01-04-2004,01-04-2004,1,0,12509,12509
878,operating,12300000,2,07-02-2003,10-10-2003,7,245,12090,12335
879,operating,100000,1,01-08-2008,01-08-2008,1,0,14092,14092
880,operating,2000000,1,16-11-2015,16-11-2015,1,0,16755,16755
881,closed,320000,3,08-06-2012,22-04-2014,2,683,15499,16182
882,closed,,1,25-09-2015,25-09-2015,1,0,16703,16703
883,operating,,1,24-10-2003,24-10-2003,3,0,12349,12349
884,operating,665404.0822,2,01-05-2014,27-10-2015,1,544,16191,16735
885,closed,150000000,1,01-06-2000,01-06-2000,11,0,11109,11109
886,closed,31253119.89,1,27-01-2005,27-01-2005,5,0,12810,12810
887,operating,192990,1,01-10-2013,01-10-2013,1,0,15979,15979
888,operating,50000,1,01-06-2013,01-06-2013,2,0,15857,15857
889,closed,,1,01-01-1999,01-01-1999,1,0,10592,10592
890,operating,1280000,1,24-08-2009,24-08-2009,2,0,14480,14480
891,operating,3273650,3,05-02-2009,17-09-2013,8,1685,14280,15965
892,closed,50000,1,01-04-2012,01-04-2012,1,0,15431,15431
893,operating,5500000,2,01-10-2009,16-09-2013,1,1446,14518,15964
894,closed,,1,01-01-2007,01-01-2007,1,0,13514,13514
895,closed,,1,15-10-2014,15-10-2014,1,0,16358,16358
896,closed,16781,1,02-03-2015,02-03-2015,1,0,16496,16496
897,operating,4700000,1,01-06-2015,01-06-2015,2,0,16587,16587
898,closed,720480,1,01-11-2005,01-11-2005,1,0,13088,13088
899,operating,500000,1,22-05-2015,22-05-2015,1,0,16577,16577
900,acquired,1000000,2,25-01-2012,13-11-2012,10,293,15364,15657
901,closed,12500,1,01-08-2015,01-08-2015,1,0,16648,16648
902,operating,5665000,2,01-03-2009,30-07-2010,4,516,14304,14820
903,operating,6807327,2,05-06-2014,07-05-2015,2,336,16226,16562
904,operating,30000000,1,01-03-2009,01-03-2009,1,0,14304,14304
905,closed,600000,1,01-10-2012,01-10-2012,1,0,15614,15614
906,operating,,1,02-08-2010,02-08-2010,1,0,14823,14823
907,operating,307954,2,01-01-2010,01-01-2011,1,365,14610,14975
908,operating,100000,1,12-04-2013,12-04-2013,4,0,15807,15807
909,operating,65000000,2,12-06-2000,21-11-2003,12,1257,11120,12377
910,closed,,1,01-01-2009,01-01-2009,1,0,14245,14245
911,operating,19051289,2,10-09-2003,24-11-2010,5,2632,12305,14937
912,operating,19000000,2,30-11-2011,28-03-2013,4,484,15308,15792
913,operating,,1,15-08-2011,15-08-2011,1,0,15201,15201
914,operating,,2,10-01-2014,16-09-2014,2,249,16080,16329
915,operating,13000000,3,01-07-2010,01-04-2014,6,1370,14791,16161
916,operating,4311170,1,18-04-2011,18-04-2011,1,0,15082,15082
917,operating,110000000,1,03-09-2014,03-09-2014,1,0,16316,16316
918,operating,25000,1,01-01-2013,01-01-2013,1,0,15706,15706
919,operating,70799998,11,01-01-2004,11-07-2014,18,3844,12418,16262
920,operating,14000000,2,10-07-2006,04-02-2009,3,940,13339,14279
921,operating,,1,22-01-2013,22-01-2013,1,0,15727,15727
922,acquired,,2,15-02-2011,31-05-2011,5,105,15020,15125
923,operating,,1,30-06-2011,30-06-2011,1,0,15155,15155
924,operating,2325000,2,13-03-2013,28-01-2015,7,686,15777,16463
925,operating,3174603,1,01-01-2012,01-01-2012,1,0,15340,15340
926,acquired,20190000,2,12-01-2004,11-10-2005,8,638,12429,13067
927,operating,62000,2,20-08-2012,20-12-2012,1,122,15572,15694
928,acquired,,1,31-12-2011,31-12-2011,1,0,15339,15339
929,closed,38000000,2,01-10-2003,13-10-2005,5,743,12326,13069
930,operating,840000,3,10-09-2013,05-05-2015,14,602,15958,16560
931,operating,1200000,1,08-03-2010,08-03-2010,2,0,14676,14676
932,operating,7183800,1,07-02-2006,07-02-2006,1,0,13186,13186
933,operating,,1,22-09-2014,22-09-2014,1,0,16335,16335
934,operating,410423,1,16-06-2011,16-06-2011,1,0,15141,15141
935,operating,138581610,5,16-09-2004,25-10-2013,4,3326,12677,16003
936,operating,7000000,1,23-12-2014,23-12-2014,2,0,16427,16427
937,operating,,1,23-08-2015,23-08-2015,5,0,16670,16670
938,operating,1350000,1,25-08-2015,25-08-2015,5,0,16672,16672
939,ipo,70950000,3,11-06-2010,28-06-2013,11,1113,14771,15884
940,operating,500000,1,10-01-2007,10-01-2007,1,0,13523,13523
941,operating,,1,05-06-2015,05-06-2015,1,0,16591,16591
942,operating,20500000,2,04-06-2013,09-05-2014,3,339,15860,16199
943,operating,,1,25-07-2015,25-07-2015,1,0,16641,16641
944,operating,1500000,1,17-08-2015,17-08-2015,1,0,16664,16664
945,operating,500000,1,15-10-2015,15-10-2015,3,0,16723,16723
946,operating,20228,1,01-09-2014,01-09-2014,1,0,16314,16314
947,closed,7000000,1,14-07-2008,14-07-2008,3,0,14074,14074
948,operating,9000000,3,12-08-2012,29-09-2015,3,1143,15564,16707
949,closed,250000,1,26-10-2011,26-10-2011,1,0,15273,15273
950,operating,8316271,4,23-02-2012,03-09-2015,18,1288,15393,16681
951,closed,17000000,2,16-04-2007,22-10-2008,6,555,13619,14174
952,operating,89948,1,01-11-2013,01-11-2013,1,0,16010,16010
953,operating,,1,09-12-2013,09-12-2013,1,0,16048,16048
954,closed,4000000,1,26-02-2007,26-02-2007,1,0,13570,13570
955,closed,441277.7049,1,06-10-2005,06-10-2005,1,0,13062,13062
956,closed,1475482,1,30-10-2002,30-10-2002,2,0,11990,11990
957,operating,12500,1,01-12-2014,01-12-2014,1,0,16405,16405
958,operating,21700000,2,24-09-2007,06-11-2013,4,2235,13780,16015
959,operating,,1,27-01-2003,27-01-2003,1,0,12079,12079
960,acquired,,1,01-12-2009,01-12-2009,1,0,14579,14579
961,closed,5700000,3,01-01-2004,01-12-2007,2,1430,12418,13848
962,operating,175000,1,28-09-2010,28-09-2010,1,0,14880,14880
963,operating,10845000,5,29-06-2011,21-10-2015,5,1575,15154,16729
964,operating,225000,2,01-09-2012,05-12-2013,2,460,15584,16044
965,operating,2945000,4,11-07-2013,03-09-2015,8,784,15897,16681
966,operating,15500000,1,27-11-2007,27-11-2007,3,0,13844,13844
967,operating,950000,1,30-01-2014,30-01-2014,1,0,16100,16100
968,acquired,26298436,3,01-06-2004,07-04-2015,5,3962,12570,16532
969,closed,300000,1,06-04-2011,06-04-2011,2,0,15070,15070
970,operating,2700000,5,29-06-2011,16-05-2014,7,1052,15154,16206
971,operating,15152514,1,03-03-2014,03-03-2014,1,0,16132,16132
972,operating,120107,3,01-09-2013,01-11-2014,2,426,15949,16375
973,operating,594287,1,22-07-2014,22-07-2014,1,0,16273,16273
974,operating,20000,1,01-05-2015,01-05-2015,2,0,16556,16556
975,operating,2520000,3,01-04-2014,03-04-2015,9,367,16161,16528
976,operating,11200000,2,01-01-2013,20-05-2014,4,504,15706,16210
977,operating,15500000,3,01-10-2012,17-11-2015,12,1142,15614,16756
978,ipo,558950000,11,01-09-2005,01-07-2014,46,3225,13027,16252
979,operating,,1,01-12-2011,01-12-2011,1,0,15309,15309
980,operating,9500005,4,06-01-2010,01-04-2013,1,1181,14615,15796
981,operating,10000,1,01-01-2014,01-01-2014,1,0,16071,16071
982,acquired,6500000,2,01-11-1999,13-06-2000,5,225,10896,11121
983,operating,2275000,5,27-05-2010,01-09-2013,7,1193,14756,15949
984,operating,12850000,3,25-06-2013,02-09-2014,15,434,15881,16315
985,operating,30000000,1,01-03-2012,01-03-2012,2,0,15400,15400
986,operating,1503657,1,02-01-2015,02-01-2015,1,0,16437,16437
987,operating,,1,01-02-2014,01-02-2014,2,0,16102,16102
988,operating,12000000,3,01-01-2013,01-10-2013,5,273,15706,15979
989,acquired,10000000,1,23-05-2005,23-05-2005,2,0,12926,12926
990,operating,,1,12-09-2014,12-09-2014,1,0,16325,16325
991,operating,,2,28-03-2014,07-07-2014,1,101,16157,16258
992,operating,825000,1,07-12-2010,07-12-2010,1,0,14950,14950
993,operating,144400000,3,19-01-2012,13-05-2014,14,845,15358,16203
994,operating,350000,1,28-09-2015,28-09-2015,1,0,16706,16706
995,closed,,1,01-06-2008,01-06-2008,1,0,14031,14031
996,operating,13660000,1,01-06-2006,01-06-2006,1,0,13300,13300
997,operating,87200000,5,01-11-2011,22-01-2015,14,1178,15279,16457
998,operating,,1,17-03-2015,17-03-2015,1,0,16511,16511
999,operating,,1,07-08-2008,07-08-2008,1,0,14098,14098
1000,acquired,800000,1,01-08-2008,01-08-2008,1,0,14092,14092
1001,operating,20000,1,01-01-2012,01-01-2012,1,0,15340,15340
1002,closed,1000000,1,04-07-2013,04-07-2013,2,0,15890,15890
1003,operating,58250000,5,01-06-2011,18-09-2015,17,1570,15126,16696
1004,ipo,333200000,2,01-09-1999,16-10-2007,5,2967,10835,13802
1005,operating,3030502,1,04-02-2014,04-02-2014,4,0,16105,16105
1006,operating,1000000,1,02-12-2011,02-12-2011,1,0,15310,15310
1007,operating,11158362,5,09-09-2009,28-09-2012,3,1115,14496,15611
1008,operating,840000,2,10-01-2014,14-04-2015,1,459,16080,16539
1009,operating,16500000,2,20-01-2004,11-06-2007,4,1238,12437,13675
1010,operating,414957,2,05-04-2013,15-04-2014,1,375,15800,16175
1011,operating,14250000,1,12-08-2011,12-08-2011,1,0,15198,15198
1012,closed,138000,1,01-05-2011,01-05-2011,5,0,15095,15095
1013,operating,,1,10-10-2015,10-10-2015,2,0,16718,16718
1014,operating,,1,01-11-2013,01-11-2013,2,0,16010,16010
1015,operating,20000,1,01-06-2013,01-06-2013,1,0,15857,15857
1016,operating,28000,1,01-02-2013,01-02-2013,1,0,15737,15737
1017,operating,,1,01-02-2015,01-02-2015,1,0,16467,16467
1018,operating,926349,2,08-10-2008,22-05-2013,6,1687,14160,15847
1019,operating,20000000,1,05-11-2014,05-11-2014,1,0,16379,16379
1020,operating,22000000,2,01-01-2013,24-02-2014,3,419,15706,16125
1021,operating,8500000,1,01-08-1999,01-08-1999,4,0,10804,10804
1022,operating,22577276,6,09-06-2010,16-09-2015,15,1925,14769,16694
1023,operating,28701975,5,01-09-2005,22-08-2012,5,2547,13027,15574
1024,operating,,1,01-06-2014,01-06-2014,1,0,16222,16222
1025,operating,13000000,1,15-10-2014,15-10-2014,2,0,16358,16358
1026,acquired,3307299,4,12-09-2005,10-06-2011,1,2097,13038,15135
1027,operating,28040440,1,23-07-2015,23-07-2015,1,0,16639,16639
1028,operating,97000000,2,21-11-2013,12-03-2015,7,476,16030,16506
1029,operating,12200000,1,27-05-2010,27-05-2010,3,0,14756,14756
1030,acquired,43000000,2,07-11-2007,04-02-2010,7,820,13824,14644
1031,operating,17300000,5,04-09-2006,25-12-2013,8,2669,13395,16064
1032,closed,1180000,2,22-08-2012,19-03-2013,10,209,15574,15783
1033,operating,20450000,2,17-04-2003,02-06-2004,5,412,12159,12571
1034,operating,,1,01-07-2015,01-07-2015,6,0,16617,16617
1035,operating,2400000,1,01-11-2009,01-11-2009,1,0,14549,14549
1036,operating,3300000,1,04-03-2014,04-03-2014,3,0,16133,16133
1037,operating,393781,3,09-10-2013,01-12-2014,3,418,15987,16405
1038,ipo,24983103,6,06-08-2010,10-11-2014,1,1557,14827,16384
1039,operating,5099999,2,21-08-2013,12-05-2014,7,264,15938,16202
1040,operating,1500000,2,01-05-2009,24-08-2010,1,480,14365,14845
1041,operating,1602564,1,01-11-2012,01-11-2012,1,0,15645,15645
1042,operating,4094392,1,06-07-2015,06-07-2015,1,0,16622,16622
1043,operating,,1,01-01-2014,01-01-2014,1,0,16071,16071
1044,acquired,600000,1,01-08-2003,01-08-2003,1,0,12265,12265
1045,operating,,1,03-11-2013,03-11-2013,1,0,16012,16012
1046,operating,,1,12-04-2007,12-04-2007,1,0,13615,13615
1047,operating,24469821,5,19-05-2004,15-07-2015,4,4074,12557,16631
1048,operating,42200000,4,14-03-2012,28-05-2015,13,1170,15413,16583
1049,operating,,2,29-07-2013,01-10-2014,4,429,15915,16344
1050,operating,1650000,3,01-01-2012,23-10-2014,10,1026,15340,16366
1051,operating,,1,25-05-2012,25-05-2012,1,0,15485,15485
1052,operating,2043396,4,16-04-2012,27-02-2014,10,682,15446,16128
1053,operating,40000,1,10-02-2012,10-02-2012,1,0,15380,15380
1054,operating,500000,1,01-05-2014,01-05-2014,2,0,16191,16191
1055,closed,,1,22-07-2015,22-07-2015,1,0,16638,16638
1056,acquired,,1,01-04-2002,01-04-2002,1,0,11778,11778
1057,operating,,1,23-08-2011,23-08-2011,4,0,15209,15209
1058,operating,500000,1,25-06-2015,25-06-2015,1,0,16611,16611
1059,operating,900000,2,21-03-2013,10-07-2013,3,111,15785,15896
1060,operating,,1,09-03-2015,09-03-2015,1,0,16503,16503
1061,operating,162778,1,01-06-2013,01-06-2013,1,0,15857,15857
1062,operating,,1,26-02-2014,26-02-2014,1,0,16127,16127
1063,acquired,13622803,6,01-01-1999,28-03-2014,9,5565,10592,16157
1064,operating,12300000,1,06-05-2015,06-05-2015,1,0,16561,16561
1065,operating,3200000,2,20-02-2014,20-08-2015,2,546,16121,16667
1066,operating,4800000,1,17-04-2014,17-04-2014,1,0,16177,16177
1067,operating,15500000,1,28-08-2008,28-08-2008,2,0,14119,14119
1068,acquired,4000000,1,01-11-2002,01-11-2002,3,0,11992,11992
1069,acquired,3100000,1,01-02-2006,01-02-2006,5,0,13180,13180
1070,acquired,14400000,2,11-09-2012,10-05-2013,2,241,15594,15835
1071,acquired,29468580.24,3,01-12-2007,01-08-2012,10,1705,13848,15553
1072,closed,,1,01-07-2012,01-07-2012,1,0,15522,15522
1073,operating,,1,12-03-2014,12-03-2014,1,0,16141,16141
1074,operating,,2,01-12-2014,20-08-2015,2,262,16405,16667
1075,acquired,24621060,5,01-05-2006,16-03-2015,12,3241,13269,16510
1076,operating,250000,2,15-10-2013,01-01-2014,4,78,15993,16071
1077,operating,,1,21-03-2014,21-03-2014,8,0,16150,16150
1078,operating,5000000,1,01-10-2008,01-10-2008,1,0,14153,14153
1079,operating,1100000,1,17-07-2014,17-07-2014,1,0,16268,16268
1080,operating,57417398,5,27-07-2004,01-05-2012,10,2835,12626,15461
1081,operating,220000,3,01-06-2013,01-12-2014,3,548,15857,16405
1082,acquired,68760000,3,12-03-2003,17-07-2008,15,1954,12123,14077
1083,operating,771000,1,13-03-2008,13-03-2008,1,0,13951,13951
1084,operating,15000000,1,22-12-1999,22-12-1999,3,0,10947,10947
1085,operating,126980,2,01-09-2014,01-11-2014,2,61,16314,16375
1086,operating,35200000,7,01-10-2012,09-02-2015,36,861,15614,16475
1087,operating,,1,01-08-2008,01-08-2008,1,0,14092,14092
1088,operating,,1,02-12-2009,02-12-2009,2,0,14580,14580
1089,operating,33000000,2,02-10-2012,13-05-2013,3,223,15615,15838
1090,operating,1461360,1,12-07-2012,12-07-2012,5,0,15533,15533
1091,operating,1500000,2,11-10-2013,10-03-2015,4,515,15989,16504
1092,operating,193679,1,04-06-2013,04-06-2013,1,0,15860,15860
1093,operating,,1,18-07-2013,18-07-2013,1,0,15904,15904
1094,ipo,24000000,1,28-10-2010,28-10-2010,2,0,14910,14910
1095,operating,2500000,1,14-07-2014,14-07-2014,1,0,16265,16265
1096,closed,,1,01-01-2010,01-01-2010,1,0,14610,14610
1097,acquired,10000000,1,27-07-2012,27-07-2012,1,0,15548,15548
1098,closed,8800000,1,03-02-2000,03-02-2000,3,0,10990,10990
1099,operating,,2,01-06-2012,10-08-2015,2,1165,15492,16657
1100,operating,100606.1077,1,30-11-2015,30-11-2015,1,0,16769,16769
1101,operating,,1,01-04-2012,01-04-2012,3,0,15431,15431
1102,operating,,1,28-04-2014,28-04-2014,4,0,16188,16188
1103,operating,12500,1,01-07-2014,01-07-2014,1,0,16252,16252
1104,operating,29000000,2,18-06-2014,03-11-2015,6,503,16239,16742
1105,operating,,1,01-01-2014,01-01-2014,1,0,16071,16071
1106,closed,2500000,1,20-05-2008,20-05-2008,1,0,14019,14019
1107,closed,500000,1,20-04-2011,20-04-2011,1,0,15084,15084
1108,operating,2000000,1,20-11-2014,20-11-2014,1,0,16394,16394
1109,operating,500000,2,03-03-2014,01-06-2014,1,90,16132,16222
1110,operating,7960177.28,4,01-01-2002,17-11-2009,7,2877,11688,14565
1111,operating,,1,01-05-2015,01-05-2015,1,0,16556,16556
1112,operating,367500,2,01-03-2013,18-09-2013,1,201,15765,15966
1113,operating,,1,01-01-2014,01-01-2014,1,0,16071,16071
1114,operating,43000000,2,01-08-2010,23-06-2011,3,326,14822,15148
1115,operating,,1,08-10-2013,08-10-2013,1,0,15986,15986
1116,acquired,29600000,2,29-07-2002,04-10-2010,12,2989,11897,14886
1117,operating,2341414,2,01-01-2007,01-12-2011,4,1795,13514,15309
1118,operating,18522536,5,24-08-2005,03-11-2011,8,2262,13019,15281
1119,operating,,1,23-09-2014,23-09-2014,3,0,16336,16336
1120,operating,28700000,3,26-09-2005,22-07-2014,7,3221,13052,16273
1121,closed,10000000,1,23-11-2009,23-11-2009,2,0,14571,14571
1122,operating,2840000,1,24-06-2010,24-06-2010,1,0,14784,14784
1123,operating,,2,05-11-2014,24-02-2015,2,111,16379,16490
1124,operating,,1,22-01-2011,22-01-2011,1,0,14996,14996
1125,operating,1958750,4,27-10-2010,18-09-2014,1,1422,14909,16331
1126,operating,7500000,2,08-10-2013,25-03-2015,8,533,15986,16519
1127,operating,4350000,2,01-06-2014,01-10-2015,1,487,16222,16709
1128,operating,50000000,1,21-11-2007,21-11-2007,8,0,13838,13838
1129,operating,831916,4,01-04-2013,01-04-2015,4,730,15796,16526
1130,operating,405157,1,04-04-2014,04-04-2014,1,0,16164,16164
1131,operating,1080000,2,14-11-2014,12-03-2015,7,118,16388,16506
1132,operating,20000000,1,29-10-2008,29-10-2008,3,0,14181,14181
1133,operating,,1,20-12-2011,20-12-2011,1,0,15328,15328
1134,operating,1000000,1,27-10-2015,27-10-2015,9,0,16735,16735
1135,operating,16940000,1,02-02-2006,02-02-2006,3,0,13181,13181
1136,operating,2000000,1,03-03-2015,03-03-2015,9,0,16497,16497
1137,operating,6000000,1,25-06-2015,25-06-2015,2,0,16611,16611
1138,operating,19000000,1,02-02-2000,02-02-2000,3,0,10989,10989
1139,operating,237280,1,01-05-2009,01-05-2009,1,0,14365,14365
1140,operating,3516137,4,03-10-2011,21-11-2014,6,1145,15250,16395
1141,operating,12500,1,01-12-2014,01-12-2014,1,0,16405,16405
1142,operating,,1,07-12-2011,07-12-2011,1,0,15315,15315
1143,operating,,1,30-10-2015,30-10-2015,2,0,16738,16738
1144,operating,2500000,1,08-05-2007,08-05-2007,1,0,13641,13641
1145,operating,1030000,3,17-01-2006,09-03-2009,3,1147,13165,14312
1146,operating,,1,01-06-2007,01-06-2007,6,0,13665,13665
1147,closed,42119415,5,11-06-2008,30-01-2012,6,1328,14041,15369
1148,operating,,1,03-11-2015,03-11-2015,1,0,16742,16742
1149,operating,111000000,5,16-06-2006,04-02-2014,16,2790,13315,16105
1150,acquired,10000000,1,18-01-2008,18-01-2008,2,0,13896,13896
1151,closed,77000,2,15-11-2011,01-09-2012,1,291,15293,15584
1152,operating,,1,16-09-2009,16-09-2009,1,0,14503,14503
1153,operating,,2,01-02-2014,01-01-2015,2,334,16102,16436
1154,operating,5000000,1,30-10-2015,30-10-2015,1,0,16738,16738
1155,operating,11365000,2,27-05-2010,29-09-2010,2,125,14756,14881
1156,acquired,4000000,1,22-06-2001,22-06-2001,2,0,11495,11495
1157,operating,19500000,3,12-07-2012,20-02-2013,1,223,15533,15756
1158,operating,357399,5,13-07-2011,04-11-2013,2,845,15168,16013
1159,operating,4000000,1,24-06-2014,24-06-2014,1,0,16245,16245
1160,operating,225000,1,01-04-2014,01-04-2014,2,0,16161,16161
1161,operating,2300000,1,03-10-2012,03-10-2012,2,0,15616,15616
1162,operating,,2,14-02-2002,18-02-2003,2,369,11732,12101
1163,operating,2033700,1,08-05-2007,08-05-2007,1,0,13641,13641
1164,acquired,2000000,1,09-02-2011,09-02-2011,1,0,15014,15014
1165,operating,350000,2,01-11-2014,31-03-2015,4,150,16375,16525
1166,operating,369247364,5,01-06-2010,19-03-2014,10,1387,14761,16148
1167,operating,3500000,2,03-05-2012,01-11-2013,8,547,15463,16010
1168,operating,333000,2,01-02-2012,28-04-2014,5,817,15371,16188
1169,acquired,10234700,1,01-09-2008,01-09-2008,1,0,14123,14123
1170,operating,11075781.42,1,12-09-2007,12-09-2007,1,0,13768,13768
1171,operating,10500000,1,11-02-2005,11-02-2005,1,0,12825,12825
1172,operating,1600000,2,01-04-2014,28-10-2014,2,210,16161,16371
1173,operating,,1,03-02-2015,03-02-2015,1,0,16469,16469
1174,closed,1000000,1,01-10-2007,01-10-2007,1,0,13787,13787
1175,operating,25000,1,01-07-2012,01-07-2012,1,0,15522,15522
1176,acquired,2300000,2,01-03-2011,07-06-2012,7,464,15034,15498
1177,closed,,1,09-09-2013,09-09-2013,1,0,15957,15957
1178,closed,7500000,1,26-11-2003,26-11-2003,1,0,12382,12382
1179,operating,4139999,1,22-04-2014,22-04-2014,3,0,16182,16182
1180,operating,303204,1,01-01-2015,01-01-2015,1,0,16436,16436
1181,operating,7000000,2,01-02-2002,18-08-2008,2,2390,11719,14109
1182,operating,1000000,1,01-06-2014,01-06-2014,3,0,16222,16222
1183,operating,7000000,1,11-11-2014,11-11-2014,1,0,16385,16385
1184,operating,,1,24-11-2014,24-11-2014,5,0,16398,16398
1185,ipo,208949997,6,01-10-2003,31-05-2011,9,2799,12326,15125
1186,operating,8454877,3,13-01-2007,01-07-2010,3,1265,13526,14791
1187,operating,140893,3,01-03-2013,10-01-2014,3,315,15765,16080
1188,operating,115000,4,01-05-2013,05-02-2015,5,645,15826,16471
1189,operating,1150000,2,01-06-2007,01-10-2011,4,1583,13665,15248
1190,operating,4120000,2,25-02-2015,04-08-2015,6,160,16491,16651
1191,operating,3200000,2,03-10-2013,15-09-2014,3,347,15981,16328
1192,operating,3111992,1,22-07-2015,22-07-2015,1,0,16638,16638
1193,operating,688629,1,01-04-2014,01-04-2014,2,0,16161,16161
1194,operating,,1,21-03-2014,21-03-2014,1,0,16150,16150
1195,closed,4300000,1,25-03-2008,25-03-2008,2,0,13963,13963
1196,operating,,1,13-08-2013,13-08-2013,1,0,15930,15930
1197,operating,100000,1,01-10-2010,01-10-2010,1,0,14883,14883
1198,operating,11819107,1,29-08-2013,29-08-2013,4,0,15946,15946
1199,operating,10000000,1,17-08-2013,17-08-2013,1,0,15934,15934
1200,operating,7800000,3,17-09-2014,10-11-2015,7,419,16330,16749
1201,acquired,105517223,7,01-05-2007,23-09-2014,21,2702,13634,16336
1202,operating,870280,3,02-06-2013,13-05-2015,5,710,15858,16568
1203,operating,125000,1,01-10-2012,01-10-2012,1,0,15614,15614
1204,operating,,5,25-07-2012,08-01-2014,2,532,15546,16078
1205,operating,1400000,1,13-09-2013,13-09-2013,1,0,15961,15961
1206,acquired,40600000,2,10-02-2003,02-11-2004,18,631,12093,12724
1207,operating,738000,1,22-04-2010,22-04-2010,1,0,14721,14721
1208,operating,8815715,3,01-01-2007,18-09-2009,3,991,13514,14505
1209,ipo,840945776,7,01-01-2005,10-01-2014,35,3296,12784,16080
1210,acquired,1600000,1,01-01-2013,01-01-2013,3,0,15706,15706
1211,ipo,,1,01-01-2000,01-01-2000,1,0,10957,10957
1212,operating,70000,1,20-11-2009,20-11-2009,1,0,14568,14568
1213,operating,20000,1,01-06-2010,01-06-2010,1,0,14761,14761
1214,operating,,1,11-11-2014,11-11-2014,1,0,16385,16385
1215,acquired,,1,26-02-2008,26-02-2008,1,0,13935,13935
1216,operating,500000,1,06-02-2014,06-02-2014,3,0,16107,16107
1217,acquired,1000000,1,01-01-2009,01-01-2009,1,0,14245,14245
1218,operating,3834862,1,18-02-2004,18-02-2004,2,0,12466,12466
1219,closed,5200000,2,19-05-2011,13-12-2012,1,574,15113,15687
1220,operating,19000000,2,02-05-2013,01-08-2015,4,821,15827,16648
1221,operating,,1,05-02-2015,05-02-2015,1,0,16471,16471
1222,closed,500000,1,01-12-2010,01-12-2010,1,0,14944,14944
1223,operating,,1,06-02-2014,06-02-2014,1,0,16107,16107
1224,operating,612533.108,2,23-02-2014,21-10-2015,6,605,16124,16729
1225,operating,,1,11-11-2013,11-11-2013,1,0,16020,16020
1226,operating,32500,1,09-01-2013,09-01-2013,1,0,15714,15714
1227,operating,12500000,2,01-02-2003,01-12-2005,2,1034,12084,13118
1228,operating,3907466,4,30-12-2011,05-03-2015,4,1161,15338,16499
1229,operating,10000000,2,01-06-2012,28-04-2015,3,1061,15492,16553
1230,operating,,1,22-09-2015,22-09-2015,7,0,16700,16700
1231,operating,2349768,6,06-06-2011,19-11-2014,3,1262,15131,16393
1232,operating,270000,2,30-12-2013,31-03-2014,4,91,16069,16160
1233,operating,2000000,1,05-10-2006,05-10-2006,1,0,13426,13426
1234,operating,460244466,11,11-06-2009,13-08-2015,26,2254,14406,16660
1235,operating,5270907.053,1,24-06-2011,24-06-2011,2,0,15149,15149
1236,closed,1400000,1,25-01-2015,25-01-2015,1,0,16460,16460
1237,acquired,14000000,2,01-01-2008,02-01-2008,3,1,13879,13880
1238,ipo,126385000,3,31-03-2003,02-01-2013,8,3565,12142,15707
1239,operating,58500000,3,13-05-2004,19-07-2007,15,1162,12551,13713
1240,operating,12600000,3,08-05-2012,07-11-2014,1,913,15468,16381
1241,operating,34000000,2,30-04-2014,05-05-2015,5,370,16190,16560
1242,operating,20000000,2,11-12-2009,05-07-2011,7,571,14589,15160
1243,operating,154392,1,07-08-2013,07-08-2013,4,0,15924,15924
1244,operating,100000,1,01-01-2011,01-01-2011,1,0,14975,14975
1245,operating,12075000,3,19-11-2001,23-06-2006,8,1677,11645,13322
1246,operating,,4,13-05-2008,01-01-2014,7,2059,14012,16071
1247,operating,1250000,1,08-03-2013,08-03-2013,12,0,15772,15772
1248,acquired,15600000,5,01-06-2012,12-08-2015,8,1167,15492,16659
1249,operating,95199996,5,30-11-2012,29-07-2015,6,971,15674,16645
1250,operating,243540,1,25-09-2012,25-09-2012,1,0,15608,15608
1251,operating,2630000,3,20-03-2014,09-02-2015,5,326,16149,16475
1252,closed,13410000,3,15-01-2004,10-03-2009,10,1881,12432,14313
1253,operating,,1,14-04-2015,14-04-2015,1,0,16539,16539
1254,operating,7500000,2,03-06-2008,25-08-2010,3,813,14033,14846
1255,operating,787030,2,30-04-2014,07-07-2014,4,68,16190,16258
1256,operating,90000000,2,21-11-2005,23-09-2010,2,1767,13108,14875
1257,operating,120000000,5,01-01-2011,18-12-2014,34,1447,14975,16422
1258,operating,147584247,5,13-08-2009,29-08-2013,1,1477,14469,15946
1259,operating,4000000,1,01-06-2015,01-06-2015,1,0,16587,16587
1260,closed,136332,1,01-05-2001,01-05-2001,1,0,11443,11443
1261,operating,64330,1,19-08-2013,19-08-2013,1,0,15936,15936
1262,operating,8000000,1,03-09-2015,03-09-2015,3,0,16681,16681
1263,operating,19000000,2,18-06-2015,22-06-2015,1,4,16604,16608
1264,operating,,1,05-12-2011,05-12-2011,1,0,15313,15313
1265,operating,7111591,2,01-01-2010,24-10-2013,5,1392,14610,16002
1266,operating,118000,1,27-07-2015,27-07-2015,1,0,16643,16643
1267,operating,470000,1,24-02-2014,24-02-2014,1,0,16125,16125
1268,acquired,33728379,2,15-01-2004,21-09-2009,5,2076,12432,14508
1269,operating,31000000,2,01-09-2013,17-06-2014,4,289,15949,16238
1270,operating,33214215,8,13-09-2007,14-05-2015,4,2800,13769,16569
1271,operating,1000000,1,25-11-2014,25-11-2014,6,0,16399,16399
1272,operating,2000000,1,08-04-2014,08-04-2014,3,0,16168,16168
1273,operating,305000,3,04-09-2008,04-07-2014,2,2129,14126,16255
1274,operating,2000000,1,19-01-2010,19-01-2010,1,0,14628,14628
1275,acquired,775000,1,06-09-2010,06-09-2010,2,0,14858,14858
1276,operating,489703,1,23-10-2010,23-10-2010,2,0,14905,14905
1277,closed,,1,01-05-2010,01-05-2010,1,0,14730,14730
1278,operating,250000,1,01-09-2015,01-09-2015,1,0,16679,16679
1279,acquired,5000000,1,26-09-2002,26-09-2002,1,0,11956,11956
1280,operating,1500000,2,01-06-2009,19-01-2011,6,597,14396,14993
1281,operating,685628,4,01-01-2013,27-04-2015,4,846,15706,16552
1282,operating,1372725,3,19-06-2013,23-07-2014,3,399,15875,16274
1283,operating,70000,1,01-05-2014,01-05-2014,2,0,16191,16191
1284,operating,866950,4,01-01-2009,25-05-2012,5,1240,14245,15485
1285,operating,1300000,1,26-10-2015,26-10-2015,2,0,16734,16734
1286,operating,10000000,1,20-08-2010,20-08-2010,3,0,14841,14841
1287,operating,115000,1,13-08-2013,13-08-2013,1,0,15930,15930
1288,operating,1075000,2,23-03-2014,15-04-2015,3,388,16152,16540
1289,operating,20000000,2,24-09-2013,10-02-2015,5,504,15972,16476
1290,acquired,20000000,1,01-12-2009,01-12-2009,1,0,14579,14579
1291,acquired,28000000,2,04-06-2001,19-05-2003,9,714,11477,12191
1292,operating,,1,11-01-2012,11-01-2012,1,0,15350,15350
1293,operating,1650000,1,01-07-2014,01-07-2014,1,0,16252,16252
1294,operating,5000000,1,18-09-2013,18-09-2013,7,0,15966,15966
1295,closed,,1,25-09-2008,25-09-2008,1,0,14147,14147
1296,operating,16325814,3,01-12-2006,12-06-2013,3,2385,13483,15868
1297,operating,650000,3,21-11-2013,28-05-2014,1,188,16030,16218
1298,operating,873720,3,15-08-2011,24-10-2013,2,801,15201,16002
1299,operating,5000000,1,22-02-2015,22-02-2015,4,0,16488,16488
1300,operating,3350000,4,01-05-2010,02-06-2014,1,1493,14730,16223
1301,operating,12600000,1,06-06-2001,06-06-2001,5,0,11479,11479
1302,closed,35000000,1,04-06-2001,04-06-2001,6,0,11477,11477
1303,acquired,9000000,2,01-02-2011,01-03-2012,3,394,15006,15400
1304,operating,50000,1,01-05-2015,01-05-2015,1,0,16556,16556
1305,operating,,1,02-08-2008,02-08-2008,1,0,14093,14093
1306,operating,,7,18-11-2013,29-10-2015,2,710,16027,16737
1307,operating,,1,21-06-2012,21-06-2012,1,0,15512,15512
1308,acquired,17750000,3,17-07-2009,13-06-2011,10,696,14442,15138
1309,operating,,1,30-07-2015,30-07-2015,3,0,16646,16646
1310,operating,1700000,1,17-08-2012,17-08-2012,1,0,15569,15569
1311,operating,644692,1,12-11-2010,12-11-2010,1,0,14925,14925
1312,closed,,1,14-10-2007,14-10-2007,3,0,13800,13800
1313,operating,2263475,5,01-01-2007,19-07-2011,4,1660,13514,15174
1314,operating,1800000,3,01-08-2014,24-02-2015,5,207,16283,16490
1315,operating,2000000,1,17-09-2014,17-09-2014,16,0,16330,16330
1316,operating,625000,2,13-09-2013,12-05-2014,2,241,15961,16202
1317,operating,5750000,1,18-03-2014,18-03-2014,2,0,16147,16147
1318,operating,,1,08-11-2012,08-11-2012,1,0,15652,15652
1319,acquired,,1,06-08-2014,06-08-2014,1,0,16288,16288
1320,operating,,1,03-06-2014,03-06-2014,2,0,16224,16224
1321,closed,1877418.001,1,06-06-2014,06-06-2014,1,0,16227,16227
1322,acquired,43000000,1,07-11-2003,07-11-2003,8,0,12363,12363
1323,operating,430000,1,01-04-2013,01-04-2013,1,0,15796,15796
1324,operating,50000000,1,11-03-2011,11-03-2011,1,0,15044,15044
1325,operating,,1,01-06-2015,01-06-2015,1,0,16587,16587
1326,operating,30000000,1,13-01-2015,13-01-2015,1,0,16448,16448
1327,operating,190000,2,01-08-2014,01-11-2014,3,92,16283,16375
1328,acquired,,1,01-08-2002,01-08-2002,1,0,11900,11900
1329,acquired,3474608,2,24-02-2007,02-07-2008,2,494,13568,14062
1330,operating,1123603,1,06-03-2015,06-03-2015,4,0,16500,16500
1331,operating,275000,3,01-05-2013,01-09-2014,1,488,15826,16314
1332,operating,6000000,1,05-03-2014,05-03-2014,1,0,16134,16134
1333,operating,190000,1,27-02-2013,27-02-2013,1,0,15763,15763
1334,operating,,1,01-06-2010,01-06-2010,1,0,14761,14761
1335,ipo,152001200,4,07-07-2008,11-09-2012,5,1527,14067,15594
1336,closed,170604000,1,20-07-2009,20-07-2009,4,0,14445,14445
1337,acquired,1315000,4,01-06-2008,13-02-2014,12,2083,14031,16114
1338,operating,163309,1,01-10-2013,01-10-2013,1,0,15979,15979
1339,operating,650591,2,25-02-2014,27-08-2015,4,548,16126,16674
1340,operating,,1,30-04-2009,30-04-2009,1,0,14364,14364
1341,operating,9001000,4,23-05-2012,22-04-2013,2,334,15483,15817
1342,operating,300000,1,01-03-2013,01-03-2013,1,0,15765,15765
1343,acquired,482786,1,01-11-2012,01-11-2012,1,0,15645,15645
1344,operating,500000,1,08-10-2008,08-10-2008,1,0,14160,14160
1345,operating,22630691,3,30-05-2005,31-10-2013,11,3076,12933,16009
1346,operating,2000000,2,09-08-2012,27-12-2013,6,505,15561,16066
1347,acquired,3000000,1,08-05-2012,08-05-2012,1,0,15468,15468
1348,operating,1100000,1,01-10-2015,01-10-2015,4,0,16709,16709
1349,operating,4100000,2,22-03-2012,17-06-2013,12,452,15421,15873
1350,operating,25000000,2,24-06-2003,05-04-2004,5,286,12227,12513
1351,operating,25000003,2,30-06-2009,20-05-2013,1,1420,14425,15845
1352,operating,289256,1,01-06-2013,01-06-2013,1,0,15857,15857
1353,operating,35000000,3,21-08-2009,06-08-2012,5,1081,14477,15558
1354,operating,40000,1,19-12-2011,19-12-2011,1,0,15327,15327
1355,operating,1560000,2,07-03-2006,09-02-2009,5,1070,13214,14284
1356,operating,2076178,2,01-03-2010,01-03-2012,2,731,14669,15400
1357,acquired,26000000,1,04-08-2005,04-08-2005,2,0,12999,12999
1358,operating,,1,01-12-2006,01-12-2006,1,0,13483,13483
1359,closed,5000000,1,01-08-2007,01-08-2007,1,0,13726,13726
1360,operating,474545,2,01-05-2013,01-12-2013,3,214,15826,16040
1361,operating,,1,30-04-2013,30-04-2013,1,0,15825,15825
1362,operating,400000,2,01-01-2014,01-11-2014,1,304,16071,16375
1363,operating,1523520,2,24-08-2010,13-11-2012,3,812,14845,15657
1364,operating,3000000,1,11-09-2015,11-09-2015,6,0,16689,16689
1365,operating,,1,06-10-2011,06-10-2011,1,0,15253,15253
1366,operating,12000000,2,01-07-2010,01-01-2012,1,549,14791,15340
1367,operating,,1,10-07-2014,10-07-2014,3,0,16261,16261
1368,operating,1100000,1,05-06-2014,05-06-2014,2,0,16226,16226
1369,operating,51470000,5,03-03-2012,21-07-2015,12,1235,15402,16637
1370,acquired,50000000,1,03-09-2008,03-09-2008,4,0,14125,14125
1371,operating,5000000,1,30-09-2014,30-09-2014,1,0,16343,16343
1372,operating,15300000,1,02-11-1999,02-11-1999,1,0,10897,10897
1373,operating,,1,01-09-2009,01-09-2009,1,0,14488,14488
1374,operating,,1,14-01-2014,14-01-2014,1,0,16084,16084
1375,operating,270862,1,12-06-2014,12-06-2014,1,0,16233,16233
1376,operating,,1,01-03-2011,01-03-2011,1,0,15034,15034
1377,operating,5000000,1,16-10-2014,16-10-2014,3,0,16359,16359
1378,operating,55000,2,01-09-2013,01-01-2014,3,122,15949,16071
1379,operating,14481680.93,2,07-08-2014,14-10-2015,18,433,16289,16722
1380,operating,1100000,1,19-03-2015,19-03-2015,1,0,16513,16513
1381,operating,,1,01-10-2011,01-10-2011,1,0,15248,15248
1382,operating,996400,2,28-07-2009,05-05-2014,1,1742,14453,16195
1383,operating,3500000,1,15-10-2011,15-10-2011,1,0,15262,15262
1384,operating,,1,16-04-2015,16-04-2015,1,0,16541,16541
1385,operating,46150818,4,08-01-2009,13-05-2013,11,1586,14252,15838
1386,operating,,1,01-01-2011,01-01-2011,1,0,14975,14975
1387,operating,2520000,1,01-01-2013,01-01-2013,11,0,15706,15706
1388,operating,235677,2,20-12-2011,01-06-2014,1,894,15328,16222
1389,operating,2250000,2,01-12-2014,12-11-2015,5,346,16405,16751
1390,acquired,28000000,4,28-01-2003,08-11-2006,8,1380,12080,13460
1391,operating,2805000,3,11-09-2013,17-06-2015,7,644,15959,16603
1392,operating,1138136,4,01-03-2013,20-02-2015,4,721,15765,16486
1393,operating,12500000,2,01-07-2005,18-02-2007,2,597,12965,13562
1394,operating,,1,04-10-2012,04-10-2012,3,0,15617,15617
1395,operating,760000,3,06-03-2015,10-07-2015,1,126,16500,16626
1396,acquired,11500000,2,04-02-2008,14-07-2008,3,161,13913,14074
1397,operating,150000,1,15-08-2011,15-08-2011,1,0,15201,15201
1398,operating,500000,1,27-06-2014,27-06-2014,1,0,16248,16248
1399,operating,3000000,2,07-01-2008,13-08-2010,2,949,13885,14834
1400,operating,33724,1,01-05-2014,01-05-2014,2,0,16191,16191
1401,acquired,12000000,2,24-01-2001,11-12-2001,12,321,11346,11667
1402,closed,21000000,2,12-08-2005,12-09-2007,9,761,13007,13768
1403,operating,76000000,7,24-05-2007,18-09-2014,14,2674,13657,16331
1404,operating,3200000,2,22-10-2015,22-10-2015,10,0,16730,16730
1405,operating,611631,1,06-02-2015,06-02-2015,1,0,16472,16472
1406,operating,25000,1,13-02-2015,13-02-2015,1,0,16479,16479
1407,operating,100000,1,01-10-2011,01-10-2011,1,0,15248,15248
1408,acquired,3050000,3,20-06-2014,20-10-2014,2,122,16241,16363
1409,operating,18000000,1,27-07-2011,27-07-2011,2,0,15182,15182
1410,acquired,5000000,1,22-03-2005,22-03-2005,3,0,12864,12864
1411,operating,390000,2,10-02-2013,25-10-2013,3,257,15746,16003
1412,operating,1100000,1,15-09-2014,15-09-2014,3,0,16328,16328
1413,operating,93000000,3,01-04-1998,13-11-2014,3,6070,10317,16387
1414,operating,,1,01-01-2001,01-01-2001,1,0,11323,11323
1415,operating,,1,11-04-2011,11-04-2011,1,0,15075,15075
1416,operating,253000000,6,01-06-2005,03-08-2013,11,2985,12935,15920
1417,closed,4000000,1,27-02-2007,27-02-2007,2,0,13571,13571
1418,operating,117000,3,10-01-2014,14-08-2014,1,216,16080,16296
1419,operating,8000000,1,03-06-2003,03-06-2003,1,0,12206,12206
1420,closed,7207,1,01-08-2011,01-08-2011,1,0,15187,15187
1421,operating,490512,6,01-11-2011,28-01-2015,5,1184,15279,16463
1422,ipo,515000000,3,11-05-2006,07-07-2013,6,2614,13279,15893
1423,operating,142765,1,01-02-2013,01-02-2013,2,0,15737,15737
1424,operating,475000,2,01-10-2013,01-05-2014,6,212,15979,16191
1425,closed,300000,2,01-05-2007,01-06-2008,4,397,13634,14031
1426,operating,,1,09-12-2013,09-12-2013,1,0,16048,16048
1427,operating,570000,3,01-07-2012,01-03-2014,4,608,15522,16130
1428,operating,2183409,5,01-04-2011,01-04-2014,6,1096,15065,16161
1429,operating,32407715,4,08-01-2010,29-06-2015,4,1998,14617,16615
1430,operating,11587263,3,07-08-2009,15-08-2011,1,738,14463,15201
1431,closed,20000000,1,25-02-2002,25-02-2002,2,0,11743,11743
1432,acquired,,1,01-06-2007,01-06-2007,1,0,13665,13665
1433,operating,448436,1,27-08-2013,27-08-2013,1,0,15944,15944
1434,operating,20000,1,14-10-2014,14-10-2014,1,0,16357,16357
1435,operating,,1,01-12-2009,01-12-2009,1,0,14579,14579
1436,closed,16437900,6,29-03-2007,21-12-2010,8,1363,13601,14964
1437,operating,,1,28-09-2012,28-09-2012,1,0,15611,15611
1438,operating,,1,01-09-2002,01-09-2002,1,0,11931,11931
1439,acquired,165500000,2,24-09-2001,16-08-2002,16,326,11589,11915
1440,operating,86000000,3,25-04-2013,26-08-2014,4,488,15820,16308
1441,operating,1635523,2,29-10-2013,20-01-2015,2,448,16007,16455
1442,operating,22500000,3,12-08-2008,17-09-2013,3,1862,14103,15965
1443,operating,18000,1,01-06-2013,01-06-2013,1,0,15857,15857
1444,closed,1080000,1,07-04-2008,07-04-2008,1,0,13976,13976
1445,operating,44972579,8,13-07-2009,11-05-2015,7,2128,14438,16566
1446,closed,5000000,1,02-12-2008,02-12-2008,1,0,14215,14215
1447,operating,92500000,3,09-01-2014,24-06-2015,11,531,16079,16610
1448,closed,9470000,2,02-06-2008,21-10-2008,5,141,14032,14173
1449,operating,2200000,2,01-01-2013,20-10-2014,4,657,15706,16363
1450,operating,,1,28-08-2014,28-08-2014,1,0,16310,16310
1451,operating,500000,1,06-11-2013,06-11-2013,1,0,16015,16015
1452,operating,34078,1,01-06-2014,01-06-2014,1,0,16222,16222
1453,operating,6600000,2,20-03-2014,20-07-2015,3,487,16149,16636
1454,acquired,7000000,1,01-12-2006,01-12-2006,2,0,13483,13483
1455,operating,400000,1,01-08-2013,01-08-2013,1,0,15918,15918
1456,operating,12000000,1,01-06-2004,01-06-2004,3,0,12570,12570
1457,operating,4705893,2,09-10-2013,25-02-2015,4,504,15987,16491
1458,acquired,,1,01-06-2012,01-06-2012,1,0,15492,15492
1459,operating,705000,2,01-02-2015,29-09-2015,1,240,16467,16707
1460,operating,903171,3,01-04-2011,01-10-2014,2,1279,15065,16344
1461,operating,500000,1,01-07-2012,01-07-2012,1,0,15522,15522
1462,operating,107800000,3,23-07-2014,10-11-2015,4,475,16274,16749
1463,acquired,,1,04-04-2007,04-04-2007,1,0,13607,13607
1464,operating,96500000,1,01-12-2007,01-12-2007,3,0,13848,13848
1465,operating,4550000,7,31-05-2011,31-08-2015,9,1553,15125,16678
1466,operating,,1,01-05-2011,01-05-2011,1,0,15095,15095
1467,closed,1500000,1,01-09-2009,01-09-2009,1,0,14488,14488
1468,closed,10000000,1,22-11-1999,22-11-1999,4,0,10917,10917
1469,operating,9300000,1,21-11-2011,21-11-2011,1,0,15299,15299
1470,operating,886699,1,23-10-2012,23-10-2012,3,0,15636,15636
1471,operating,1000000,3,01-02-2010,01-02-2012,6,730,14641,15371
1472,operating,1700000,1,01-02-2013,01-02-2013,1,0,15737,15737
1473,closed,512000,2,01-07-2011,11-01-2012,4,194,15156,15350
1474,operating,,1,29-05-2013,29-05-2013,1,0,15854,15854
1475,operating,20000,1,18-07-2014,18-07-2014,1,0,16269,16269
1476,operating,6500000,2,13-07-2012,01-12-2015,7,1236,15534,16770
1477,operating,156000000,1,24-12-2002,24-12-2002,4,0,12045,12045
1478,operating,,1,01-12-2014,01-12-2014,1,0,16405,16405
1479,closed,374157.9578,2,10-06-2015,07-09-2015,2,89,16596,16685
1480,operating,1100000,1,15-10-2013,15-10-2013,8,0,15993,15993
1481,operating,4714510,2,01-06-2012,01-12-2013,4,548,15492,16040
1482,operating,5000000,1,11-08-2015,11-08-2015,1,0,16658,16658
1483,operating,250000,1,01-01-2008,01-01-2008,1,0,13879,13879
1484,operating,4979900,3,22-11-2013,29-10-2015,5,706,16031,16737
1485,operating,4790345,2,01-07-2011,26-05-2015,3,1425,15156,16581
1486,operating,,1,15-01-2002,15-01-2002,1,0,11702,11702
1487,acquired,96000000,6,14-04-2011,04-05-2015,3,1481,15078,16559
1488,operating,,1,13-12-2014,13-12-2014,1,0,16417,16417
1489,operating,1700000,1,06-06-2013,06-06-2013,1,0,15862,15862
1490,operating,,1,01-02-2011,01-02-2011,1,0,15006,15006
1491,operating,20000,1,18-07-2014,18-07-2014,1,0,16269,16269
1492,operating,1270324,1,12-11-2012,12-11-2012,2,0,15656,15656
1493,acquired,8500000,2,21-02-2012,26-02-2013,3,371,15391,15762
1494,operating,19177200,7,26-05-2010,20-02-2015,2,1731,14755,16486
1495,operating,13091862,4,15-09-2008,01-07-2014,4,2115,14137,16252
1496,operating,600000,2,01-01-2010,01-08-2014,2,1673,14610,16283
1497,operating,6960000,2,17-05-2006,11-08-2008,8,817,13285,14102
1498,operating,9000000,2,06-10-2014,26-08-2015,9,324,16349,16673
1499,closed,40968,1,06-12-2013,06-12-2013,1,0,16045,16045
1500,acquired,33272398,2,01-10-2012,23-06-2014,5,630,15614,16244
1501,operating,2000000,1,04-08-2015,04-08-2015,1,0,16651,16651
1502,operating,155000,1,27-10-2006,27-10-2006,1,0,13448,13448
1503,operating,1010000,2,01-10-2014,20-02-2015,1,142,16344,16486
1504,operating,2000000,1,03-11-2013,03-11-2013,3,0,16012,16012
1505,operating,21000000,3,01-02-2008,25-07-2014,7,2366,13910,16276
1506,closed,1000000,1,01-01-2007,01-01-2007,1,0,13514,13514
1507,operating,110000,1,25-11-2015,25-11-2015,2,0,16764,16764
1508,operating,51126,1,01-05-2012,01-05-2012,1,0,15461,15461
1509,operating,17900000,1,17-12-2002,17-12-2002,3,0,12038,12038
1510,operating,18584,1,01-06-2012,01-06-2012,1,0,15492,15492
1511,operating,264094,1,01-01-2013,01-01-2013,1,0,15706,15706
1512,acquired,32000000,1,01-10-2002,01-10-2002,1,0,11961,11961
1513,operating,13300000,1,06-12-2013,06-12-2013,2,0,16045,16045
1514,acquired,500000,1,09-02-2010,09-02-2010,1,0,14649,14649
1515,operating,20000000,3,31-12-2011,01-10-2013,10,640,15339,15979
1516,operating,34790000,5,05-10-2011,06-10-2015,16,1462,15252,16714
1517,operating,2000000,1,04-06-2003,04-06-2003,2,0,12207,12207
1518,operating,4902500,3,15-04-2013,18-01-2015,2,643,15810,16453
1519,operating,,2,01-11-2013,01-03-2015,3,485,16010,16495
1520,operating,500000,1,28-01-2013,28-01-2013,1,0,15733,15733
1521,operating,100000,1,18-01-2014,18-01-2014,1,0,16088,16088
1522,acquired,,1,02-12-2003,02-12-2003,1,0,12388,12388
1523,operating,226609,1,09-08-2012,09-08-2012,1,0,15561,15561
1524,operating,,1,25-10-2012,25-10-2012,2,0,15638,15638
1525,operating,8500000,1,30-11-2012,30-11-2012,4,0,15674,15674
1526,operating,15000,1,01-05-2010,01-05-2010,1,0,14730,14730
1527,operating,,1,08-08-2011,08-08-2011,1,0,15194,15194
1528,operating,525000,5,01-02-2012,27-01-2014,9,726,15371,16097
1529,operating,4300000,1,05-03-2003,05-03-2003,6,0,12116,12116
1530,operating,1000000,1,25-04-2013,25-04-2013,6,0,15820,15820
1531,closed,1450000,1,30-04-2008,30-04-2008,4,0,13999,13999
1532,operating,146769846,7,25-11-2009,09-09-2015,21,2114,14573,16687
1533,closed,18500000,1,07-11-2006,07-11-2006,3,0,13459,13459
1534,ipo,21000000,2,24-09-2001,24-06-2014,8,4656,11589,16245
1535,operating,65900000,4,01-11-2011,18-07-2015,6,1355,15279,16634
1536,acquired,475000,3,01-02-2010,06-11-2012,7,1009,14641,15650
1537,operating,6847000,5,28-06-2010,03-12-2015,21,1984,14788,16772
1538,acquired,1522481,1,01-10-2007,01-10-2007,1,0,13787,13787
1539,operating,250000,1,30-03-2008,30-03-2008,1,0,13968,13968
1540,closed,20000,1,01-02-2012,01-02-2012,1,0,15371,15371
1541,operating,1000000,1,06-11-2014,06-11-2014,1,0,16380,16380
1542,ipo,60000000,1,13-05-2014,13-05-2014,1,0,16203,16203
1543,operating,6100000,2,30-11-2011,05-08-2012,2,249,15308,15557
1544,acquired,13618793,6,01-01-2010,16-10-2012,18,1019,14610,15629
1545,operating,,1,01-09-2014,01-09-2014,1,0,16314,16314
1546,operating,36800000,1,14-04-2015,14-04-2015,1,0,16539,16539
1547,operating,,1,31-01-2008,31-01-2008,1,0,13909,13909
1548,closed,,1,01-06-2015,01-06-2015,1,0,16587,16587
1549,operating,2250000,3,01-05-2011,01-08-2013,4,823,15095,15918
1550,operating,12100000,3,16-08-2011,30-01-2014,4,898,15202,16100
1551,operating,65864387,5,04-04-2006,30-04-2015,12,3313,13242,16555
1552,operating,,3,24-01-2013,17-02-2015,17,754,15729,16483
1553,operating,28289100,1,01-02-2008,01-02-2008,2,0,13910,13910
1554,operating,3230000,1,11-01-2010,11-01-2010,2,0,14620,14620
1555,operating,20460000,4,01-06-2010,24-07-2012,2,784,14761,15545
1556,operating,1500000,1,08-04-2014,08-04-2014,1,0,16168,16168
1557,operating,13787114,1,24-07-2015,24-07-2015,4,0,16640,16640
1558,ipo,46000000,6,27-07-2011,08-09-2014,2,1139,15182,16321
1559,closed,995928,2,01-01-2009,01-01-2010,2,365,14245,14610
1560,acquired,,1,20-12-2007,20-12-2007,1,0,13867,13867
1561,operating,5700000,1,03-03-2015,03-03-2015,2,0,16497,16497
1562,acquired,10000000,1,04-11-2005,04-11-2005,2,0,13091,13091
1563,operating,2500000,1,30-01-2008,30-01-2008,1,0,13908,13908
1564,closed,,1,30-06-2014,30-06-2014,1,0,16251,16251
1565,operating,77717024,6,30-04-2003,16-02-2011,14,2849,12172,15021
1566,operating,3203515,3,26-04-2012,18-05-2014,1,752,15456,16208
1567,acquired,20250000,2,27-05-2009,15-02-2011,1,629,14391,15020
1568,operating,10000,1,01-05-2013,01-05-2013,1,0,15826,15826
1569,operating,23000000,2,09-02-2009,14-09-2011,2,947,14284,15231
1570,operating,370000,2,02-12-2011,19-06-2012,1,200,15310,15510
1571,operating,25662500,3,18-10-2011,09-12-2014,5,1148,15265,16413
1572,operating,16000,1,15-06-2013,15-06-2013,1,0,15871,15871
1573,operating,150000,1,15-11-2012,15-11-2012,1,0,15659,15659
1574,operating,10494514,4,22-12-2011,13-05-2014,9,873,15330,16203
1575,operating,47893037,9,02-10-2002,04-01-2013,33,3747,11962,15709
1576,operating,750000,1,25-11-2013,25-11-2013,1,0,16034,16034
1577,operating,,1,12-09-2011,12-09-2011,1,0,15229,15229
1578,operating,150035000,5,04-08-2010,07-10-2014,14,1525,14825,16350
1579,acquired,35032734,3,10-11-2011,29-04-2014,4,901,15288,16189
1580,operating,,1,01-12-2007,01-12-2007,1,0,13848,13848
1581,operating,,1,23-08-2014,23-08-2014,1,0,16305,16305
1582,operating,994000,1,19-10-2007,19-10-2007,2,0,13805,13805
1583,operating,661000,1,12-05-2010,12-05-2010,2,0,14741,14741
1584,operating,3493737,1,01-05-2001,01-05-2001,1,0,11443,11443
1585,operating,5400000,1,03-12-2014,03-12-2014,5,0,16407,16407
1586,operating,,1,01-12-2014,01-12-2014,1,0,16405,16405
1587,operating,7483000,1,10-11-2009,10-11-2009,1,0,14558,14558
1588,ipo,9521365,2,12-05-2011,31-10-2014,3,1268,15106,16374
1589,operating,5260000,1,01-03-2014,01-03-2014,2,0,16130,16130
1590,operating,,1,01-09-2013,01-09-2013,1,0,15949,15949
1591,operating,,1,01-03-2015,01-03-2015,1,0,16495,16495
1592,operating,2254102,2,24-02-2006,28-10-2014,3,3168,13203,16371
1593,operating,138845088,18,14-01-2004,06-07-2015,37,4191,12431,16622
1594,operating,80319,1,07-01-2013,07-01-2013,1,0,15712,15712
1595,operating,1535000,4,01-03-2013,13-03-2015,15,742,15765,16507
1596,acquired,17590000,2,18-11-2007,30-09-2009,6,682,13835,14517
1597,operating,300000000,1,13-12-2013,13-12-2013,1,0,16052,16052
1598,ipo,78050000,5,01-11-2003,19-11-2012,13,3306,12357,15663
1599,operating,51185512,2,27-02-2013,10-04-2015,1,772,15763,16535
1600,operating,5200000,1,31-03-2014,31-03-2014,2,0,16160,16160
1601,closed,52600000,1,05-11-2001,05-11-2001,10,0,11631,11631
1602,acquired,,1,01-05-2010,01-05-2010,1,0,14730,14730
1603,operating,,3,20-02-2013,01-12-2015,8,1014,15756,16770
1604,operating,799686,1,01-07-2015,01-07-2015,2,0,16617,16617
1605,operating,16000000,2,01-01-2006,05-09-2013,1,2804,13149,15953
1606,operating,3758095,1,09-09-2015,09-09-2015,3,0,16687,16687
1607,operating,,1,12-11-2014,12-11-2014,1,0,16386,16386
1608,operating,43900000,4,22-09-2011,08-04-2015,15,1294,15239,16533
1609,operating,400000,1,07-11-2012,07-11-2012,1,0,15651,15651
1610,operating,400000,2,01-05-2012,15-10-2013,1,532,15461,15993
1611,acquired,26750000,3,12-01-2006,03-11-2011,3,2121,13160,15281
1612,acquired,,1,01-09-2011,01-09-2011,1,0,15218,15218
1613,ipo,418400000,4,29-07-2008,01-04-2015,2,2437,14089,16526
1614,operating,47200000,5,07-11-2007,10-12-2014,8,2590,13824,16414
1615,closed,,1,18-04-1990,18-04-1990,1,0,7412,7412
1616,operating,10000000,1,28-09-2015,28-09-2015,5,0,16706,16706
1617,acquired,,1,05-01-2007,05-01-2007,1,0,13518,13518
1618,operating,80100000,7,01-01-2008,23-04-2015,18,2669,13879,16548
1619,operating,15870000,2,14-09-2007,17-03-2009,3,550,13770,14320
1620,closed,3529175,2,05-06-2009,28-12-2009,2,206,14400,14606
1621,operating,7800000,1,19-05-2008,19-05-2008,1,0,14018,14018
1622,closed,25000,1,01-03-2012,01-03-2012,1,0,15400,15400
1623,operating,50000,1,01-07-2014,01-07-2014,2,0,16252,16252
1624,operating,1000000,3,01-03-2012,15-01-2014,7,685,15400,16085
1625,operating,23000000,2,08-08-2013,02-10-2014,7,420,15925,16345
1626,operating,18120360,8,26-04-2011,27-05-2015,1,1492,15090,16582
1627,operating,469044,1,01-07-2014,01-07-2014,1,0,16252,16252
1628,operating,1473000,6,01-01-2010,01-01-2013,13,1096,14610,15706
1629,operating,,1,08-08-2012,08-08-2012,1,0,15560,15560
1630,ipo,4500000,2,30-09-2010,14-01-2014,1,1202,14882,16084
1631,operating,5820000,3,13-12-2006,06-12-2013,2,2550,13495,16045
1632,ipo,25250000,4,28-05-2013,02-10-2014,1,492,15853,16345
1633,operating,100000,1,28-04-2009,28-04-2009,1,0,14362,14362
1634,operating,,1,01-06-2011,01-06-2011,1,0,15126,15126
1635,operating,240348,1,01-12-2012,01-12-2012,3,0,15675,15675
1636,operating,8800000,2,17-08-2015,12-09-2015,5,26,16664,16690
1637,operating,4050000,3,01-01-2007,03-11-2008,6,672,13514,14186
1638,operating,31150000,3,17-03-2008,26-01-2015,6,2506,13955,16461
1639,acquired,38764000,4,10-10-2005,01-04-2012,7,2365,13066,15431
1640,operating,15931,1,11-04-2015,11-04-2015,1,0,16536,16536
1641,acquired,86000000,3,07-02-2003,26-05-2005,20,839,12090,12929
1642,operating,14094700,2,16-02-2010,15-05-2014,4,1549,14656,16205
1643,operating,28000000,2,18-09-2012,22-10-2012,4,34,15601,15635
1644,acquired,50000,1,14-02-2011,14-02-2011,1,0,15019,15019
1645,operating,,1,02-11-2012,02-11-2012,1,0,15646,15646
1646,operating,863000,1,19-12-2007,19-12-2007,2,0,13866,13866
1647,closed,250000,1,03-01-2010,03-01-2010,1,0,14612,14612
1648,closed,,1,31-12-2007,31-12-2007,1,0,13878,13878
1649,operating,1000000,1,22-12-2014,22-12-2014,2,0,16426,16426
1650,operating,,1,08-01-2014,08-01-2014,1,0,16078,16078
1651,operating,6300000,2,26-06-2007,05-06-2009,3,710,13690,14400
1652,operating,3500000,2,25-09-2015,26-10-2015,2,31,16703,16734
1653,operating,10000000,1,27-03-2013,27-03-2013,1,0,15791,15791
1654,operating,2999989,1,21-05-2014,21-05-2014,1,0,16211,16211
1655,operating,1500000,1,13-04-2015,13-04-2015,1,0,16538,16538
1656,operating,3600000,1,19-05-2011,19-05-2011,1,0,15113,15113
1657,closed,,1,18-12-2008,18-12-2008,1,0,14231,14231
1658,operating,,1,10-10-2007,10-10-2007,2,0,13796,13796
1659,operating,540000,3,01-07-2013,01-06-2015,1,700,15887,16587
1660,operating,5695948,2,11-07-2014,24-08-2015,3,409,16262,16671
1661,operating,,1,01-01-2007,01-01-2007,5,0,13514,13514
1662,operating,1100000,2,09-11-2007,15-01-2010,2,798,13826,14624
1663,operating,35000000,2,25-06-2007,22-08-2013,4,2250,13689,15939
1664,operating,2500000,1,27-10-2015,27-10-2015,1,0,16735,16735
1665,acquired,31700000,2,07-05-2009,10-05-2010,6,368,14371,14739
1666,closed,500000,1,20-03-2007,20-03-2007,1,0,13592,13592
1667,operating,1921592,5,01-09-2013,09-09-2015,8,738,15949,16687
1668,operating,24390.2439,3,01-01-2013,20-02-2014,2,415,15706,16121
1669,operating,10000000,2,01-04-2008,08-02-2010,7,678,13970,14648
1670,operating,1190476,1,21-03-2012,21-03-2012,2,0,15420,15420
1671,operating,500000,2,29-05-2013,16-05-2014,2,352,15854,16206
1672,operating,10600000,3,18-03-2013,29-06-2015,23,833,15782,16615
1673,closed,12500000,2,01-01-2006,25-04-2007,5,479,13149,13628
1674,operating,3360807,1,03-12-2004,03-12-2004,1,0,12755,12755
1675,operating,750000,1,22-12-2009,22-12-2009,5,0,14600,14600
1676,operating,15000000,1,25-02-2015,25-02-2015,2,0,16491,16491
1677,operating,8600000,1,13-06-2013,13-06-2013,1,0,15869,15869
1678,operating,,1,26-02-2013,26-02-2013,1,0,15762,15762
1679,operating,,1,20-11-2015,20-11-2015,1,0,16759,16759
1680,operating,8000000,1,27-04-2008,27-04-2008,1,0,13996,13996
1681,operating,20395,1,01-02-2013,01-02-2013,1,0,15737,15737
1682,operating,20000,1,02-02-2015,02-02-2015,1,0,16468,16468
1683,acquired,40000000,1,01-08-2002,01-08-2002,5,0,11900,11900
1684,closed,692000,1,21-05-2008,21-05-2008,2,0,14020,14020
1685,closed,4700000,2,27-06-2008,12-07-2010,1,745,14057,14802
1686,operating,7587979,5,01-03-2012,26-03-2015,3,1120,15400,16520
1687,operating,,1,01-12-2014,01-12-2014,1,0,16405,16405
1688,operating,54090,1,31-03-2015,31-03-2015,1,0,16525,16525
1689,operating,,1,01-02-2012,01-02-2012,1,0,15371,15371
1690,operating,1500000,1,02-04-2014,02-04-2014,1,0,16162,16162
1691,operating,640000,3,23-06-2014,06-08-2014,5,44,16244,16288
1692,operating,,1,01-01-2010,01-01-2010,1,0,14610,14610
1693,operating,34300000,1,10-01-2002,10-01-2002,10,0,11697,11697
1694,acquired,47800000,4,01-03-2009,31-07-2013,20,1613,14304,15917
1695,operating,110000000,3,01-03-2010,19-04-2014,8,1510,14669,16179
1696,operating,500000,1,01-07-2006,01-07-2006,2,0,13330,13330
1697,operating,43000000,1,05-03-2001,05-03-2001,3,0,11386,11386
1698,operating,157000000,2,01-10-2009,01-07-2010,1,273,14518,14791
1699,acquired,42000000,3,14-02-2000,26-02-2001,8,378,11001,11379
1700,operating,,2,15-09-2015,12-10-2015,2,27,16693,16720
1701,operating,3181000,3,08-10-2008,22-06-2010,4,622,14160,14782
1702,operating,95097200,3,28-08-2006,01-01-2012,10,1952,13388,15340
1703,operating,,1,01-04-2013,01-04-2013,1,0,15796,15796
1704,operating,320000000,1,16-07-2015,16-07-2015,3,0,16632,16632
1705,operating,1500000,1,29-08-2013,29-08-2013,3,0,15946,15946
1706,operating,4500000,1,01-08-2008,01-08-2008,1,0,14092,14092
1707,operating,,1,02-09-2012,02-09-2012,1,0,15585,15585
1708,operating,100000,1,02-01-2014,02-01-2014,1,0,16072,16072
1709,operating,,1,01-06-2010,01-06-2010,1,0,14761,14761
1710,operating,,1,01-01-2014,01-01-2014,1,0,16071,16071
1711,closed,,1,19-05-2014,19-05-2014,1,0,16209,16209
1712,operating,975000,4,20-04-2012,27-07-2015,1,1193,15450,16643
1713,operating,2500000,1,20-05-2008,20-05-2008,1,0,14019,14019
1714,operating,151650012,13,17-04-2007,03-09-2013,23,2331,13620,15951
1715,operating,,1,17-06-2014,17-06-2014,1,0,16238,16238
1716,operating,,1,10-08-2012,10-08-2012,3,0,15562,15562
1717,operating,8425125,4,01-06-2012,09-07-2015,8,1133,15492,16625
1718,operating,155000000,4,31-01-2012,01-06-2015,18,1217,15370,16587
1719,operating,2800000,3,12-01-2013,01-04-2015,7,809,15717,16526
1720,operating,,1,01-12-2012,01-12-2012,1,0,15675,15675
1721,operating,20000000,3,23-11-2011,27-06-2014,1,947,15301,16248
1722,closed,100000000,1,29-02-2012,29-02-2012,2,0,15399,15399
1723,operating,30000,1,01-03-2015,01-03-2015,1,0,16495,16495
1724,operating,20290000,4,15-06-2007,20-08-2014,6,2623,13679,16302
1725,operating,4000000,1,12-02-2015,12-02-2015,1,0,16478,16478
1726,operating,100000,1,01-11-2014,01-11-2014,1,0,16375,16375
1727,operating,640000,3,05-04-2014,08-03-2015,2,337,16165,16502
1728,operating,12546,1,16-09-2012,16-09-2012,1,0,15599,15599
1729,operating,58475686.07,3,03-07-2013,28-10-2015,1,847,15889,16736
1730,operating,620000,1,03-05-2005,03-05-2005,2,0,12906,12906
1731,ipo,195249815,10,22-09-2011,12-05-2015,7,1328,15239,16567
1732,operating,,1,21-08-2014,21-08-2014,1,0,16303,16303
1733,ipo,111005000,7,28-10-2009,06-02-2015,6,1927,14545,16472
1734,operating,,1,15-10-2013,15-10-2013,1,0,15993,15993
1735,operating,40000,2,06-01-2014,15-05-2014,2,129,16076,16205
1736,operating,20001589,3,13-09-2002,15-01-2013,7,3777,11943,15720
1737,operating,10900000,1,20-06-2006,20-06-2006,4,0,13319,13319
1738,operating,5000000,1,24-09-2007,24-09-2007,1,0,13780,13780
1739,closed,32000000,2,01-04-2006,01-03-2007,7,334,13239,13573
1740,acquired,,1,05-04-2004,05-04-2004,2,0,12513,12513
1741,closed,45000,1,15-08-2015,15-08-2015,1,0,16662,16662
1742,operating,,1,01-03-2011,01-03-2011,2,0,15034,15034
1743,operating,4279999,2,07-02-2012,25-04-2013,1,443,15377,15820
1744,operating,250000,1,01-04-2014,01-04-2014,1,0,16161,16161
1745,operating,300000,1,01-12-2014,01-12-2014,1,0,16405,16405
1746,operating,6000000,3,04-11-2010,20-01-2014,3,1173,14917,16090
1747,operating,968755,6,26-05-2014,18-09-2015,2,480,16216,16696
1748,operating,805000,4,16-07-2013,31-10-2014,2,472,15902,16374
1749,operating,20000000,2,01-04-2010,01-05-2011,3,395,14700,15095
1750,closed,963000,1,01-12-2009,01-12-2009,2,0,14579,14579
1751,ipo,16700000,1,13-09-2002,13-09-2002,3,0,11943,11943
1752,operating,200000,1,18-09-2012,18-09-2012,1,0,15601,15601
1753,operating,27300000,1,21-09-2004,21-09-2004,1,0,12682,12682
1754,operating,,1,15-08-2011,15-08-2011,1,0,15201,15201
1755,operating,12000000,1,27-05-2013,27-05-2013,1,0,15852,15852
1756,operating,,1,18-02-2011,18-02-2011,1,0,15023,15023
1757,operating,4000000,2,01-03-2012,01-07-2013,1,487,15400,15887
1758,operating,,1,31-10-1991,31-10-1991,1,0,7973,7973
1759,acquired,7000000,2,24-05-2012,20-06-2013,11,392,15484,15876
1760,operating,,1,01-07-2012,01-07-2012,1,0,15522,15522
1761,operating,,1,01-10-2011,01-10-2011,1,0,15248,15248
1762,operating,1700000,2,23-06-2009,24-10-2013,1,1584,14418,16002
1763,operating,5435058.013,3,01-03-2008,07-11-2015,2,2807,13939,16746
1764,operating,25508000,3,28-03-2012,08-10-2015,1,1289,15427,16716
1765,operating,161812,2,17-09-2014,02-04-2015,3,197,16330,16527
1766,operating,88711.57209,2,01-09-2014,01-05-2015,2,242,16314,16556
1767,operating,2000000,2,07-07-2015,20-07-2015,5,13,16623,16636
1768,operating,,1,19-06-2013,19-06-2013,2,0,15875,15875
1769,operating,,1,05-10-2015,05-10-2015,3,0,16713,16713
1770,closed,116267844,2,23-10-2009,07-06-2010,2,227,14540,14767
1771,operating,2500000,1,05-05-2015,05-05-2015,10,0,16560,16560
1772,operating,10000000,1,05-11-2014,05-11-2014,1,0,16379,16379
1773,operating,,1,20-12-2012,20-12-2012,1,0,15694,15694
1774,operating,50000,1,24-10-2011,24-10-2011,1,0,15271,15271
1775,closed,132885,3,15-10-2011,01-07-2012,2,260,15262,15522
1776,closed,600000,1,25-08-2007,25-08-2007,1,0,13750,13750
1777,operating,5100000,1,19-03-2014,19-03-2014,4,0,16148,16148
1778,operating,804500,6,04-06-2011,01-10-2013,11,850,15129,15979
1779,operating,24100000,4,01-10-2004,05-03-2008,10,1251,12692,13943
1780,closed,9715488,3,15-08-2011,16-03-2012,3,214,15201,15415
1781,operating,91449,2,01-09-2012,20-12-2012,3,110,15584,15694
1782,operating,10283444,6,01-01-2009,28-04-2015,7,2308,14245,16553
1783,operating,2200000,1,22-06-2001,22-06-2001,2,0,11495,11495
1784,operating,340000,5,01-06-2011,02-09-2013,3,824,15126,15950
1785,closed,,6,17-06-2009,03-01-2011,6,565,14412,14977
1786,operating,10028500,11,26-07-2010,13-08-2015,6,1844,14816,16660
1787,operating,5710000,2,26-10-2005,12-11-2013,5,2939,13082,16021
1788,operating,16773,1,25-09-2015,25-09-2015,1,0,16703,16703
1789,acquired,13000000,1,14-10-2005,14-10-2005,4,0,13070,13070
1790,acquired,2000000,2,01-01-2012,18-07-2013,3,564,15340,15904
1791,operating,6452000,3,02-03-2011,21-10-2013,3,964,15035,15999
1792,acquired,44000000,1,03-12-1999,03-12-1999,2,0,10928,10928
1793,operating,10012879,5,20-08-2010,22-04-2015,6,1706,14841,16547
1794,operating,12638000,1,06-09-2012,06-09-2012,3,0,15589,15589
1795,closed,,1,01-08-2009,01-08-2009,1,0,14457,14457
1796,operating,2695400,1,27-09-2010,27-09-2010,1,0,14879,14879
1797,operating,4390000,1,10-03-2010,10-03-2010,1,0,14678,14678
1798,closed,300000,1,20-07-2011,20-07-2011,1,0,15175,15175
1799,operating,22629440,10,01-08-2008,15-06-2015,7,2509,14092,16601
1800,closed,1000000,1,01-01-2011,01-01-2011,10,0,14975,14975
1801,operating,750000,3,01-01-2011,01-11-2012,14,670,14975,15645
1802,operating,33213808,11,02-02-2007,28-02-2013,4,2218,13546,15764
1803,operating,32094,1,08-05-2013,08-05-2013,1,0,15833,15833
1804,operating,4792797,1,10-09-2012,10-09-2012,1,0,15593,15593
1805,closed,,1,01-04-2014,01-04-2014,1,0,16161,16161
1806,operating,25000000,1,08-04-2009,08-04-2009,3,0,14342,14342
1807,operating,3655264,3,18-05-2011,07-10-2013,11,873,15112,15985
1808,acquired,8000000,2,10-01-2005,11-12-2006,5,700,12793,13493
1809,operating,4250000,1,04-04-2005,04-04-2005,2,0,12877,12877
1810,operating,2370000,2,02-07-2013,04-03-2014,2,245,15888,16133
1811,acquired,,1,01-06-2011,01-06-2011,3,0,15126,15126
1812,operating,,1,01-07-2014,01-07-2014,1,0,16252,16252
1813,operating,20467015,1,01-09-2004,01-09-2004,1,0,12662,12662
1814,acquired,2000000,3,01-01-2010,26-04-2012,12,846,14610,15456
1815,operating,37345000,3,22-12-1999,08-10-2014,16,5404,10947,16351
1816,operating,20000000,3,01-02-2012,29-10-2013,6,636,15371,16007
1817,acquired,67500000,1,09-11-2011,09-11-2011,5,0,15287,15287
1818,acquired,18000000,1,28-11-2000,28-11-2000,3,0,11289,11289
1819,operating,,1,30-04-2015,30-04-2015,2,0,16555,16555
1820,acquired,181860000,7,18-12-2001,02-08-2007,24,2053,11674,13727
1821,operating,8400000,1,11-08-2005,11-08-2005,3,0,13006,13006
1822,operating,89891428,9,28-04-2006,14-08-2015,21,3395,13266,16661
1823,operating,3500000,1,18-02-2014,18-02-2014,3,0,16119,16119
1824,acquired,38000000,1,05-11-2001,05-11-2001,6,0,11631,11631
1825,operating,25000,1,20-07-2011,20-07-2011,1,0,15175,15175
1826,operating,14155000,3,03-03-2011,14-08-2014,1,1260,15036,16296
1827,operating,1897699998,11,01-01-2011,18-08-2015,34,1690,14975,16665
1828,operating,18178569,3,14-01-2014,09-11-2015,16,664,16084,16748
1829,operating,41000000,2,01-07-2014,09-02-2015,3,223,16252,16475
1830,operating,16691,1,11-07-2015,11-07-2015,1,0,16627,16627
1831,acquired,30204758.87,2,08-02-2007,14-07-2007,6,156,13552,13708
1832,operating,250000,1,28-02-2011,28-02-2011,1,0,15033,15033
1833,operating,19889,1,01-08-2013,01-08-2013,1,0,15918,15918
1834,operating,,1,05-12-2012,05-12-2012,1,0,15679,15679
1835,operating,15000000,1,30-06-2015,30-06-2015,1,0,16616,16616
1836,operating,40000,1,10-02-2012,10-02-2012,1,0,15380,15380
1837,acquired,6000000,1,01-07-2004,01-07-2004,1,0,12600,12600
1838,operating,8000000,1,17-11-2015,17-11-2015,2,0,16756,16756
1839,acquired,,1,01-04-2004,01-04-2004,1,0,12509,12509
1840,acquired,70000,2,23-01-2012,01-10-2012,2,252,15362,15614
1841,operating,27450440,3,01-06-2000,14-09-2009,12,3392,11109,14501
1842,operating,51878,1,01-09-2013,01-09-2013,1,0,15949,15949
1843,operating,4000000,1,18-06-2014,18-06-2014,1,0,16239,16239
1844,closed,,2,15-09-2015,15-09-2015,1,0,16693,16693
1845,operating,105000,3,01-03-2013,01-08-2014,1,518,15765,16283
1846,operating,8000000,2,10-02-2012,01-07-2013,4,507,15380,15887
1847,operating,,1,01-02-2000,01-02-2000,1,0,10988,10988
1848,operating,8600000,1,28-02-2008,28-02-2008,2,0,13937,13937
1849,operating,12000000,1,19-02-2001,19-02-2001,2,0,11372,11372
1850,closed,60000000,1,01-04-2003,01-04-2003,1,0,12143,12143
1851,operating,50200000,4,14-08-2013,30-03-2015,12,593,15931,16524
1852,operating,928942,2,09-09-2009,28-01-2010,2,141,14496,14637
1853,operating,,1,27-05-2014,27-05-2014,1,0,16217,16217
1854,operating,8900000,1,09-07-2015,09-07-2015,5,0,16625,16625
1855,operating,,1,21-09-2012,21-09-2012,1,0,15604,15604
1856,closed,140000,1,20-02-2012,20-02-2012,1,0,15390,15390
1857,operating,,1,03-11-2012,03-11-2012,1,0,15647,15647
1858,operating,75000,1,01-06-2012,01-06-2012,2,0,15492,15492
1859,operating,125000,4,01-04-2013,13-07-2015,3,833,15796,16629
1860,operating,6400000,1,05-08-2013,05-08-2013,1,0,15922,15922
1861,operating,248000000,1,07-08-2012,07-08-2012,1,0,15559,15559
1862,closed,12500,1,01-08-2015,01-08-2015,1,0,16648,16648
1863,acquired,161040000,3,01-01-2007,16-04-2009,7,836,13514,14350
1864,closed,1020000,2,01-07-2008,01-06-2009,2,335,14061,14396
1865,operating,21600000,2,05-11-2014,11-11-2015,5,371,16379,16750
1866,operating,10661772.9,5,15-12-2012,04-11-2015,17,1054,15689,16743
1867,operating,45000000,2,30-07-2013,15-10-2015,7,807,15916,16723
1868,operating,500000,1,23-09-2014,23-09-2014,1,0,16336,16336
1869,acquired,88150000,8,11-12-2000,07-05-2010,21,3434,11302,14736
1870,operating,,1,09-01-2014,09-01-2014,1,0,16079,16079
1871,operating,80000000,1,17-11-2015,17-11-2015,3,0,16756,16756
1872,operating,10000000,1,07-07-2014,07-07-2014,1,0,16258,16258
1873,operating,,1,15-08-2013,15-08-2013,1,0,15932,15932
1874,operating,2174140,7,12-08-2009,09-06-2015,1,2127,14468,16595
1875,acquired,900000,1,11-06-2013,11-06-2013,1,0,15867,15867
1876,closed,25000,1,02-06-2015,02-06-2015,2,0,16588,16588
1877,operating,3344760,3,01-04-2009,08-04-2015,7,2198,14335,16533
1878,operating,40000,1,10-04-2012,10-04-2012,1,0,15440,15440
1879,closed,7000000,1,27-02-2002,27-02-2002,4,0,11745,11745
1880,operating,50000,1,21-10-2010,21-10-2010,1,0,14903,14903
1881,operating,2511040,2,25-07-2012,21-03-2014,4,604,15546,16150
1882,operating,60000000,5,01-12-2007,28-01-2015,11,2615,13848,16463
1883,operating,2800000,2,04-03-2015,03-12-2015,9,274,16498,16772
1884,operating,300000,1,06-05-2013,06-05-2013,1,0,15831,15831
1885,operating,,1,27-01-2014,27-01-2014,1,0,16097,16097
1886,closed,23277501,2,30-11-2009,08-07-2011,4,585,14578,15163
1887,operating,4886,1,01-11-2014,01-11-2014,1,0,16375,16375
1888,operating,36000000,2,01-06-2006,01-02-2008,3,610,13300,13910
1889,operating,42000000,2,18-08-2015,11-11-2015,3,85,16665,16750
1890,operating,15000,1,01-05-2015,01-05-2015,1,0,16556,16556
1891,closed,,1,27-09-2015,27-09-2015,2,0,16705,16705
1892,operating,,1,17-01-2011,17-01-2011,1,0,14991,14991
1893,operating,1000000,1,05-01-2011,05-01-2011,2,0,14979,14979
1894,operating,,1,06-06-2013,06-06-2013,1,0,15862,15862
1895,operating,1044000,1,27-11-2013,27-11-2013,5,0,16036,16036
1896,operating,505000,1,01-01-2012,01-01-2012,8,0,15340,15340
1897,operating,122900000,5,21-01-2011,28-07-2015,14,1649,14995,16644
1898,operating,68357,1,20-12-2013,20-12-2013,1,0,16059,16059
1899,operating,,1,20-12-2011,20-12-2011,1,0,15328,15328
1900,acquired,18000000,1,17-01-2006,17-01-2006,4,0,13165,13165
1901,operating,40000,1,10-04-2012,10-04-2012,1,0,15440,15440
1902,operating,40000,1,30-12-2013,30-12-2013,1,0,16069,16069
1903,operating,1010000,1,17-04-2008,17-04-2008,3,0,13986,13986
1904,operating,19800000,3,02-09-2010,27-05-2014,11,1363,14854,16217
1905,operating,9200000,3,01-02-2003,01-01-2005,5,700,12084,12784
1906,operating,6159223,9,28-01-2011,24-06-2015,9,1608,15002,16610
1907,operating,1550000,1,02-04-2008,02-04-2008,3,0,13971,13971
1908,operating,5000000,1,01-03-2013,01-03-2013,1,0,15765,15765
1909,acquired,39231994,18,07-05-2001,02-07-2009,27,2978,11449,14427
1910,operating,20166221,5,26-05-2005,14-03-2012,7,2484,12929,15413
1911,operating,2550000,2,25-10-2012,31-01-2013,1,98,15638,15736
1912,closed,23519998,4,01-09-2007,24-05-2013,6,2092,13757,15849
1913,acquired,500000,2,01-01-2000,17-05-2010,2,3789,10957,14746
1914,operating,15000000,1,01-01-2014,01-01-2014,1,0,16071,16071
1915,operating,,1,01-10-2012,01-10-2012,1,0,15614,15614
1916,acquired,41000000,2,15-10-2005,16-11-2006,4,397,13071,13468
1917,operating,,1,18-08-2012,18-08-2012,1,0,15570,15570
1918,operating,12800000,1,23-09-2015,23-09-2015,1,0,16701,16701
1919,operating,665000,1,15-09-2014,15-09-2014,1,0,16328,16328
1920,operating,1140000,1,14-01-2008,14-01-2008,1,0,13892,13892
1921,operating,1000000,1,15-03-2015,15-03-2015,1,0,16509,16509
1922,operating,20000,1,05-08-2014,05-08-2014,1,0,16287,16287
1923,operating,15850000,3,06-10-2010,08-07-2013,5,1006,14888,15894
1924,operating,,1,07-04-2015,07-04-2015,3,0,16532,16532
1925,acquired,34914119,2,29-07-2004,30-07-2004,4,1,12628,12629
1926,operating,,1,09-11-2011,09-11-2011,1,0,15287,15287
1927,closed,,1,30-08-2011,30-08-2011,1,0,15216,15216
1928,operating,1100000,2,18-01-2012,03-06-2014,3,867,15357,16224
1929,operating,1500000,1,15-05-2014,15-05-2014,2,0,16205,16205
1930,operating,725609,2,30-05-2014,13-09-2015,3,471,16220,16691
1931,closed,889999,2,01-06-2007,12-04-2010,6,1046,13665,14711
1932,operating,50000,1,24-10-2011,24-10-2011,1,0,15271,15271
1933,closed,,1,25-02-2013,25-02-2013,2,0,15761,15761
1934,operating,108500000,3,12-09-2012,20-10-2015,10,1133,15595,16728
1935,operating,,1,20-04-2010,20-04-2010,1,0,14719,14719
1936,operating,2000000,3,01-04-2013,17-03-2015,6,715,15796,16511
1937,operating,1500000,1,26-12-2013,26-12-2013,1,0,16065,16065
1938,operating,,1,27-12-2010,27-12-2010,1,0,14970,14970
1939,operating,38500000,3,21-05-2011,05-05-2015,9,1445,15115,16560
1940,operating,1500000,2,01-04-2007,19-10-2009,1,932,13604,14536
1941,operating,,1,10-08-2008,10-08-2008,1,0,14101,14101
1942,operating,90889217,6,13-09-2010,15-05-2014,19,1340,14865,16205
1943,operating,432000,2,01-08-2010,10-12-2010,2,131,14822,14953
1944,operating,1500000,1,23-09-2014,23-09-2014,1,0,16336,16336
1945,operating,6400000,2,11-01-2011,04-06-2012,4,510,14985,15495
1946,acquired,49000000,3,17-09-2010,19-04-2012,26,580,14869,15449
1947,operating,200000,1,01-01-2013,01-01-2013,1,0,15706,15706
1948,operating,800000,1,22-03-2010,22-03-2010,1,0,14690,14690
1949,operating,17500000,2,01-01-2014,18-02-2014,3,48,16071,16119
1950,operating,,1,16-10-2014,16-10-2014,1,0,16359,16359
1951,operating,12000000,1,02-12-1999,02-12-1999,2,0,10927,10927
1952,acquired,6500000,2,20-12-2005,24-04-2007,5,490,13137,13627
1953,operating,40000,1,06-02-2012,06-02-2012,1,0,15376,15376
1954,closed,36004847,8,14-09-2009,14-08-2014,2,1795,14501,16296
1955,operating,49600064,5,02-11-2009,23-06-2014,3,1694,14550,16244
1956,operating,,1,01-01-2014,01-01-2014,1,0,16071,16071
1957,operating,2,1,23-09-2015,23-09-2015,1,0,16701,16701
1958,operating,,1,14-01-2014,14-01-2014,1,0,16084,16084
1959,operating,2110000,2,15-06-2015,01-10-2015,2,108,16601,16709
1960,operating,2900000,3,01-10-2010,01-11-2011,14,396,14883,15279
1961,closed,12500000,1,24-03-2004,24-03-2004,5,0,12501,12501
1962,operating,20000000,1,14-10-2015,14-10-2015,1,0,16722,16722
1963,acquired,15500000,2,17-01-2006,24-10-2007,8,645,13165,13810
1964,closed,14500000,2,07-02-2003,18-02-2004,10,376,12090,12466
1965,acquired,15200000,3,23-02-2012,09-10-2013,19,594,15393,15987
1966,operating,1151496,1,17-07-2014,17-07-2014,2,0,16268,16268
1967,operating,1000000,1,22-01-2015,22-01-2015,1,0,16457,16457
1968,operating,7800000,4,01-11-2012,18-11-2014,15,747,15645,16392
1969,operating,8595974,4,08-01-2010,24-01-2013,3,1112,14617,15729
1970,operating,3500000,1,27-06-2013,27-06-2013,1,0,15883,15883
1971,acquired,25000000,2,04-05-2007,10-07-2007,2,67,13637,13704
1972,operating,,1,24-09-2012,24-09-2012,1,0,15607,15607
1973,closed,10000000,2,14-03-2005,11-02-2008,5,1064,12856,13920
1974,operating,2620000,3,16-07-2014,06-11-2014,6,113,16267,16380
1975,operating,17517561,3,06-04-2009,01-12-2012,2,1335,14340,15675
1976,operating,47000000,2,01-04-2012,30-10-2014,2,942,15431,16373
1977,operating,,1,17-01-2014,17-01-2014,1,0,16087,16087
1978,operating,1100000,1,01-11-2013,01-11-2013,1,0,16010,16010
1979,operating,5000000,1,22-05-2008,22-05-2008,1,0,14021,14021
1980,operating,3400000,1,20-04-2005,20-04-2005,1,0,12893,12893
1981,operating,1025000,2,29-04-2010,27-09-2013,1,1247,14728,15975
1982,closed,,1,23-08-2010,23-08-2010,1,0,14844,14844
1983,operating,,1,03-09-2014,03-09-2014,1,0,16316,16316
1984,acquired,6250000,2,01-04-2012,28-05-2013,19,422,15431,15853
1985,operating,109772047,7,01-01-2007,02-12-2015,16,3257,13514,16771
1986,operating,500000,1,28-08-2014,28-08-2014,4,0,16310,16310
1987,operating,13940339,2,25-11-2014,16-09-2015,5,295,16399,16694
1988,acquired,,1,01-01-2002,01-01-2002,1,0,11688,11688
1989,operating,4766772,8,05-05-2010,29-01-2014,2,1365,14734,16099
1990,operating,265064,1,11-06-2013,11-06-2013,1,0,15867,15867
1991,operating,1700000,1,07-04-2015,07-04-2015,7,0,16532,16532
1992,operating,,2,01-01-2014,20-10-2014,2,292,16071,16363
1993,closed,9785852.919,1,31-01-2000,31-01-2000,3,0,10987,10987
1994,acquired,40000000,3,04-03-2005,30-06-2010,15,1944,12846,14790
1995,operating,56731487,6,01-03-2011,22-09-2015,20,1666,15034,16700
1996,acquired,39496651,7,17-12-2007,22-12-2014,30,2562,13864,16426
1997,operating,8850000,2,01-12-2012,06-01-2014,1,401,15675,16076
1998,operating,7417650,3,22-03-2011,07-10-2013,4,930,15055,15985
1999,operating,2000000,1,10-01-2015,10-01-2015,1,0,16445,16445
2000,operating,101060000,4,29-04-2011,01-10-2013,9,886,15093,15979
2001,operating,3250000,1,05-05-2015,05-05-2015,5,0,16560,16560
2002,operating,4000000,1,09-10-2013,09-10-2013,2,0,15987,15987
2003,operating,40000000,1,27-01-2015,27-01-2015,3,0,16462,16462
2004,operating,1500000,1,03-11-2015,03-11-2015,1,0,16742,16742
2005,operating,540000,3,01-12-2013,01-06-2015,7,547,16040,16587
2006,closed,11000,2,17-04-2011,09-06-2011,2,53,15081,15134
2007,operating,750000,1,08-02-2008,08-02-2008,3,0,13917,13917
2008,operating,360000,2,14-01-2013,17-12-2013,1,337,15719,16056
2009,operating,5145960,2,23-10-2006,30-05-2008,6,585,13444,14029
2010,operating,50000,2,12-09-2011,01-02-2012,1,142,15229,15371
2011,operating,253000,3,01-04-2014,01-10-2015,1,548,16161,16709
2012,operating,,1,31-01-2014,31-01-2014,1,0,16101,16101
2013,operating,10000000,1,16-04-2007,16-04-2007,2,0,13619,13619
2014,operating,3798698,4,01-01-2014,15-09-2015,4,622,16071,16693
2015,operating,35715957,2,07-05-2012,14-01-2014,2,617,15467,16084
2016,operating,500000,1,16-12-2013,16-12-2013,2,0,16055,16055
2017,closed,6087761.165,1,21-06-2005,21-06-2005,2,0,12955,12955
2018,operating,,1,27-01-2011,27-01-2011,1,0,15001,15001
2019,acquired,27700000,2,21-10-2010,03-08-2011,5,286,14903,15189
2020,acquired,17986943,8,09-03-2004,19-01-2012,11,2872,12486,15358
2021,operating,60358285,3,01-11-2009,18-08-2015,11,2116,14549,16665
2022,operating,22000000,1,15-07-2015,15-07-2015,2,0,16631,16631
2023,acquired,17400000,4,13-06-2008,29-07-2011,9,1141,14043,15184
2024,operating,16000000,1,14-04-2009,14-04-2009,3,0,14348,14348
2025,acquired,,1,01-10-2000,01-10-2000,1,0,11231,11231
2026,operating,52583,1,04-04-2013,04-04-2013,1,0,15799,15799
2027,closed,50511,1,10-01-2012,10-01-2012,1,0,15349,15349
2028,operating,,1,01-03-2014,01-03-2014,1,0,16130,16130
2029,operating,698135,2,04-04-2012,31-01-2014,2,667,15434,16101
2030,operating,132500000,2,26-01-2012,15-11-2013,3,659,15365,16024
2031,acquired,40800000,4,13-09-2006,15-11-2011,15,1889,13404,15293
2032,operating,35419873,3,01-01-2008,23-09-2014,5,2457,13879,16336
2033,operating,20000000,1,19-06-2012,19-06-2012,2,0,15510,15510
2034,operating,,1,01-01-2012,01-01-2012,2,0,15340,15340
2035,closed,4000000,1,23-01-2002,23-01-2002,2,0,11710,11710
2036,operating,596396,2,01-08-2013,01-01-2015,2,518,15918,16436
2037,operating,,1,01-01-2011,01-01-2011,1,0,14975,14975
2038,operating,3500000,1,16-11-2013,16-11-2013,2,0,16025,16025
2039,operating,25000000,2,01-05-2014,28-07-2015,2,453,16191,16644
2040,operating,20658,1,01-04-2014,01-04-2014,1,0,16161,16161
2041,operating,16343297,4,26-08-2010,05-03-2014,6,1287,14847,16134
2042,operating,1000000,1,22-09-2015,22-09-2015,7,0,16700,16700
2043,operating,5200000,2,25-08-2014,04-12-2015,5,466,16307,16773
2044,operating,10000000,1,12-02-2014,12-02-2014,1,0,16113,16113
2045,operating,,1,01-10-2010,01-10-2010,3,0,14883,14883
2046,operating,190671,1,01-08-2014,01-08-2014,1,0,16283,16283
2047,operating,110000000,2,01-09-2008,01-04-2010,1,577,14123,14700
2048,operating,8000000,4,17-04-2012,31-03-2015,11,1078,15447,16525
2049,closed,96800000,5,01-09-2008,01-04-2012,5,1308,14123,15431
2050,operating,1008260,2,27-09-2013,16-12-2014,9,445,15975,16420
2051,operating,65478,1,06-04-2012,06-04-2012,1,0,15436,15436
2052,operating,559521,1,07-09-2011,07-09-2011,1,0,15224,15224
2053,operating,4700000,3,02-04-2013,22-12-2014,2,629,15797,16426
2054,operating,2141000,4,23-05-2014,15-06-2015,3,388,16213,16601
2055,operating,,1,22-08-2014,22-08-2014,2,0,16304,16304
2056,operating,45225676,1,06-07-2015,06-07-2015,1,0,16622,16622
2057,closed,9500000,2,04-05-2012,22-05-2013,1,383,15464,15847
2058,acquired,4695100,2,01-01-2006,01-02-2007,5,396,13149,13545
2059,operating,65000,1,01-02-2014,01-02-2014,1,0,16102,16102
2060,operating,,1,01-12-2014,01-12-2014,1,0,16405,16405
2061,operating,2841648,2,01-01-2010,01-06-2011,3,516,14610,15126
2062,operating,811022.6539,4,01-10-2013,02-07-2015,2,639,15979,16618
2063,operating,3954556,1,24-01-2013,24-01-2013,1,0,15729,15729
2064,acquired,2030000,2,26-08-2005,08-03-2006,2,194,13021,13215
2065,operating,750000,1,01-09-2014,01-09-2014,1,0,16314,16314
2066,operating,,1,31-07-2012,31-07-2012,1,0,15552,15552
2067,closed,25000,1,01-04-2012,01-04-2012,1,0,15431,15431
2068,operating,2300000,1,22-07-2015,22-07-2015,3,0,16638,16638
2069,operating,105000000,2,11-08-2014,25-02-2015,2,198,16293,16491
2070,operating,1650000,1,11-07-2007,11-07-2007,5,0,13705,13705
2071,acquired,100496138,6,01-01-2000,12-07-2010,15,3845,10957,14802
2072,operating,1170843,1,16-01-2015,16-01-2015,1,0,16451,16451
2073,acquired,38247779,2,08-10-2001,14-05-2009,2,2775,11603,14378
2074,operating,120000,1,30-06-2014,30-06-2014,2,0,16251,16251
2075,closed,25500100,3,03-04-2007,01-01-2012,5,1734,13606,15340
2076,operating,120000,2,16-07-2014,18-08-2014,3,33,16267,16300
2077,operating,20000000,1,01-09-2014,01-09-2014,1,0,16314,16314
2078,operating,5280000,1,24-04-2006,24-04-2006,3,0,13262,13262
2079,operating,13060000,3,06-06-2005,27-02-2007,8,631,12940,13571
2080,acquired,75000000,1,19-08-2013,19-08-2013,1,0,15936,15936
2081,operating,,1,01-05-2013,01-05-2013,2,0,15826,15826
2082,operating,17225000,3,13-02-2013,05-08-2015,11,903,15749,16652
2083,operating,2000000,1,04-05-2015,04-05-2015,8,0,16559,16559
2084,operating,5560000,3,01-07-2013,17-07-2014,4,381,15887,16268
2085,closed,928135,1,19-01-2010,19-01-2010,1,0,14628,14628
2086,acquired,7500000,2,01-11-2008,18-11-2009,9,382,14184,14566
2087,operating,500000,2,22-05-2012,03-12-2012,14,195,15482,15677
2088,operating,,2,13-03-2014,23-06-2014,1,102,16142,16244
2089,acquired,12000000,1,19-11-2013,19-11-2013,9,0,16028,16028
2090,closed,6528902,3,09-02-2009,13-07-2012,1,1250,14284,15534
2091,operating,5100000,1,18-02-2003,18-02-2003,2,0,12101,12101
2092,operating,,1,01-01-2000,01-01-2000,1,0,10957,10957
2093,operating,782334,3,01-12-2011,01-12-2014,3,1096,15309,16405
2094,operating,,1,01-01-2012,01-01-2012,3,0,15340,15340
2095,operating,25000000,1,01-02-2000,01-02-2000,2,0,10988,10988
2096,operating,107474.1077,1,17-04-2015,17-04-2015,1,0,16542,16542
2097,operating,,1,28-04-2014,28-04-2014,1,0,16188,16188
2098,closed,,1,01-12-2007,01-12-2007,2,0,13848,13848
2099,operating,,1,30-05-2015,30-05-2015,1,0,16585,16585
2100,closed,8500000,1,06-01-2005,06-01-2005,1,0,12789,12789
2101,operating,300000,1,01-09-2015,01-09-2015,1,0,16679,16679
2102,operating,45400000,3,11-07-2012,12-03-2015,20,974,15532,16506
2103,operating,59100000,3,29-05-2012,18-11-2015,21,1268,15489,16757
2104,operating,900000,3,09-09-2014,06-08-2015,6,331,16322,16653
2105,operating,44500000,5,01-01-2010,04-11-2011,8,672,14610,15282
2106,operating,6000000,2,03-06-2015,01-10-2015,3,120,16589,16709
2107,closed,40000,1,01-06-2014,01-06-2014,1,0,16222,16222
2108,operating,,1,21-01-2015,21-01-2015,3,0,16456,16456
2109,operating,500000,1,16-09-2013,16-09-2013,1,0,15964,15964
2110,operating,1000000,1,18-06-2013,18-06-2013,1,0,15874,15874
2111,operating,3163478,2,02-08-2011,04-04-2013,3,611,15188,15799
2112,operating,45000000,1,15-12-2011,15-12-2011,1,0,15323,15323
2113,operating,1686275,2,01-04-2013,20-04-2015,1,749,15796,16545
2114,operating,2500000,1,28-04-2006,28-04-2006,1,0,13266,13266
2115,operating,,1,01-01-2014,01-01-2014,1,0,16071,16071
2116,operating,,1,01-01-2013,01-01-2013,1,0,15706,15706
2117,operating,17500000,2,13-05-2014,24-09-2014,15,134,16203,16337
2118,operating,40000,1,08-03-2012,08-03-2012,1,0,15407,15407
2119,acquired,17500000,2,09-08-2005,07-05-2007,5,636,13004,13640
2120,operating,20936100,2,11-11-2013,07-05-2015,4,542,16020,16562
2121,operating,200000,3,27-07-2012,15-01-2013,2,172,15548,15720
2122,operating,1500000,2,21-06-2007,01-06-2008,4,346,13685,14031
2123,operating,11000000,2,26-08-2013,17-12-2013,2,113,15943,16056
2124,operating,25000000,1,18-01-2005,18-01-2005,7,0,12801,12801
2125,operating,355000,1,02-06-2014,02-06-2014,4,0,16223,16223
2126,operating,10680000,1,17-03-2005,17-03-2005,4,0,12859,12859
2127,operating,300000,2,01-12-2011,01-07-2013,2,578,15309,15887
2128,operating,28771405,1,06-07-2015,06-07-2015,4,0,16622,16622
2129,operating,,1,01-10-2010,01-10-2010,1,0,14883,14883
2130,operating,,1,31-10-2014,31-10-2014,1,0,16374,16374
2131,acquired,2150000,2,13-06-2005,14-02-2007,5,611,12947,13558
2132,acquired,50000,1,23-10-2012,23-10-2012,1,0,15636,15636
2133,acquired,27000000,3,12-11-2007,22-06-2010,6,953,13829,14782
2134,acquired,,1,10-04-2000,10-04-2000,1,0,11057,11057
2135,ipo,194673840,6,18-03-2004,07-05-2012,23,2972,12495,15467
2136,acquired,16000000,3,01-11-2007,01-02-2011,17,1188,13818,15006
2137,operating,9000000,2,10-01-2012,17-07-2014,5,919,15349,16268
2138,closed,2000000,2,17-03-2007,20-03-2008,2,369,13589,13958
2139,operating,,1,24-05-2013,24-05-2013,1,0,15849,15849
2140,acquired,6000000,2,21-08-2001,31-10-2006,2,1897,11555,13452
2141,operating,10870000,1,07-02-2008,07-02-2008,3,0,13916,13916
2142,operating,32290000,3,01-06-2009,01-04-2012,5,1035,14396,15431
2143,operating,,1,11-05-2012,11-05-2012,1,0,15471,15471
2144,acquired,,1,01-08-2009,01-08-2009,2,0,14457,14457
2145,operating,4500000,2,10-09-2012,03-06-2015,3,996,15593,16589
2146,closed,27000000,1,08-08-2001,08-08-2001,7,0,11542,11542
2147,operating,1800000,1,05-11-2012,05-11-2012,1,0,15649,15649
2148,operating,434095,4,01-04-2012,01-10-2014,4,913,15431,16344
2149,operating,1920000,4,27-11-2011,17-07-2014,4,963,15305,16268
2150,operating,25500000,2,23-10-2014,25-02-2015,37,125,16366,16491
2151,operating,1691696,3,09-09-2013,23-04-2015,3,591,15957,16548
2152,operating,,2,01-01-2001,01-12-2006,2,2160,11323,13483
2153,operating,460000,1,03-01-2014,03-01-2014,5,0,16073,16073
2154,acquired,46800000,4,01-09-2006,29-01-2009,11,881,13392,14273
2155,operating,146100000,6,18-04-2012,27-10-2015,19,1287,15448,16735
2156,acquired,4000000,1,18-12-2007,18-12-2007,1,0,13865,13865
2157,closed,,1,01-12-2014,01-12-2014,1,0,16405,16405
2158,operating,3000000,3,15-11-2011,03-09-2013,13,658,15293,15951
2159,closed,4000000,1,18-08-2000,18-08-2000,4,0,11187,11187
2160,operating,,1,30-09-2008,30-09-2008,1,0,14152,14152
2161,operating,,1,13-05-2013,13-05-2013,1,0,15838,15838
2162,acquired,23084124,4,01-12-2005,23-11-2010,6,1818,13118,14936
2163,acquired,34400000,3,17-11-2003,01-01-2007,14,1141,12373,13514
2164,operating,10000000,4,01-03-2012,29-01-2015,14,1064,15400,16464
2165,operating,20000000,2,24-04-2013,10-12-2014,5,595,15819,16414
2166,operating,730000,2,01-10-2012,01-12-2013,3,426,15614,16040
2167,operating,75000000,1,31-01-2011,31-01-2011,2,0,15005,15005
2168,operating,6539215,2,30-10-2013,05-03-2015,6,491,16008,16499
2169,closed,38126,1,01-04-2015,01-04-2015,2,0,16526,16526
2170,operating,3000000,2,28-08-2014,13-05-2015,16,258,16310,16568
2171,operating,745000,4,01-11-2011,08-07-2014,15,980,15279,16259
2172,operating,50000,1,01-01-2015,01-01-2015,1,0,16436,16436
2173,closed,500000,1,02-02-2013,02-02-2013,1,0,15738,15738
2174,operating,,1,12-01-2014,12-01-2014,1,0,16082,16082
2175,operating,21000000,1,15-04-2014,15-04-2014,3,0,16175,16175
2176,operating,2573200,1,03-01-2014,03-01-2014,1,0,16073,16073
2177,operating,2850000,2,15-03-2013,03-01-2014,6,294,15779,16073
2178,acquired,8650000,3,18-09-2007,25-03-2011,4,1284,13774,15058
2179,operating,330000,2,01-01-2013,17-11-2013,1,320,15706,16026
2180,acquired,,1,01-03-2011,01-03-2011,1,0,15034,15034
2181,operating,100000,2,10-05-2013,01-07-2014,2,417,15835,16252
2182,operating,4000000,2,11-04-2013,10-12-2014,2,608,15806,16414
2183,operating,2030000,1,14-05-2007,14-05-2007,5,0,13647,13647
2184,operating,140000,2,01-02-2014,01-07-2014,8,150,16102,16252
2185,operating,500000,1,06-05-2015,06-05-2015,1,0,16561,16561
2186,operating,40000,1,08-06-2015,08-06-2015,1,0,16594,16594
2187,operating,1200000,1,27-12-2006,27-12-2006,1,0,13509,13509
2188,operating,20000000,1,07-06-2007,07-06-2007,6,0,13671,13671
2189,operating,,1,01-09-2012,01-09-2012,1,0,15584,15584
2190,operating,24692000,1,02-08-2012,02-08-2012,1,0,15554,15554
2191,operating,2500000,1,16-04-2013,16-04-2013,2,0,15811,15811
2192,operating,22000000,2,01-01-2002,01-01-2005,4,1096,11688,12784
2193,operating,,1,26-10-2011,26-10-2011,1,0,15273,15273
2194,operating,3000000,1,27-07-2011,27-07-2011,1,0,15182,15182
2195,acquired,7700000,1,06-02-2008,06-02-2008,2,0,13915,13915
2196,closed,,1,01-01-2015,01-01-2015,1,0,16436,16436
2197,operating,4673293,5,01-11-2011,08-01-2015,9,1164,15279,16443
2198,operating,2550000,1,14-01-2015,14-01-2015,12,0,16449,16449
2199,operating,3926094,4,01-12-2012,02-06-2015,3,913,15675,16588
2200,operating,525000,1,13-05-2015,13-05-2015,2,0,16568,16568
2201,acquired,6250000,2,26-07-2011,20-03-2012,3,238,15181,15419
2202,closed,5000000,1,30-11-1999,30-11-1999,1,0,10925,10925
2203,operating,250000,1,01-11-2003,01-11-2003,2,0,12357,12357
2204,operating,50000,1,25-08-2014,25-08-2014,1,0,16307,16307
2205,operating,,1,05-09-2008,05-09-2008,1,0,14127,14127
2206,closed,9000000,2,29-10-2008,04-02-2011,1,828,14181,15009
2207,operating,10455846,4,15-01-2013,30-06-2014,2,531,15720,16251
2208,operating,,1,01-09-2013,01-09-2013,1,0,15949,15949
2209,operating,,1,11-11-2014,11-11-2014,1,0,16385,16385
2210,closed,9100000,3,01-09-2006,22-07-2008,3,690,13392,14082
2211,operating,4000000,1,13-09-2007,13-09-2007,1,0,13769,13769
2212,operating,,1,29-06-2015,29-06-2015,2,0,16615,16615
2213,acquired,7500000,2,05-11-2009,30-08-2011,5,663,14553,15216
2214,operating,161081,2,04-03-2013,22-04-2015,2,779,15768,16547
2215,operating,1945000,2,01-09-2011,01-01-2012,2,122,15218,15340
2216,operating,5420000,1,30-09-2005,30-09-2005,2,0,13056,13056
2217,operating,13350000,4,16-05-2011,07-04-2015,15,1422,15110,16532
2218,operating,100000,1,11-01-2008,11-01-2008,1,0,13889,13889
2219,operating,,1,30-11-2013,30-11-2013,1,0,16039,16039
2220,operating,517208,3,01-04-2013,01-12-2013,6,244,15796,16040
2221,operating,350000,1,17-09-2015,17-09-2015,2,0,16695,16695
2222,operating,41250,1,01-07-2014,01-07-2014,1,0,16252,16252
2223,acquired,2574004,2,25-08-2010,25-11-2013,2,1188,14846,16034
2224,operating,,1,08-08-2008,08-08-2008,1,0,14099,14099
2225,operating,28000,1,10-07-2013,10-07-2013,1,0,15896,15896
2226,operating,8500000,4,01-12-2003,21-05-2015,7,4189,12387,16576
2227,operating,10000000,2,07-08-2014,08-08-2014,2,1,16289,16290
2228,acquired,6356500,1,28-09-2006,28-09-2006,3,0,13419,13419
2229,closed,,1,01-04-2013,01-04-2013,1,0,15796,15796
2230,operating,68000000,5,01-03-2013,19-11-2015,17,993,15765,16758
2231,operating,100000,1,09-07-2014,09-07-2014,1,0,16260,16260
2232,operating,10000000,2,06-03-2014,16-07-2014,2,132,16135,16267
2233,operating,40000001,2,23-12-2005,05-02-2013,2,2601,13140,15741
2234,operating,,1,11-11-2014,11-11-2014,2,0,16385,16385
2235,operating,39500000,2,27-11-2007,12-06-2014,3,2389,13844,16233
2236,operating,22822343,3,31-10-2008,11-09-2013,4,1776,14183,15959
2237,operating,,1,22-07-2013,22-07-2013,1,0,15908,15908
2238,operating,8000000,2,06-12-2006,16-09-2008,2,650,13488,14138
2239,operating,1000000,1,30-04-2008,30-04-2008,1,0,13999,13999
2240,operating,1350000,4,10-01-2014,07-01-2015,3,362,16080,16442
2241,closed,7575000,3,01-03-2011,01-04-2013,4,762,15034,15796
2242,ipo,28000000,2,14-12-2006,08-10-2007,7,298,13496,13794
2243,operating,120000,1,01-03-2015,01-03-2015,1,0,16495,16495
2244,operating,130000,1,09-03-2015,09-03-2015,4,0,16503,16503
2245,operating,25000,1,02-04-2012,02-04-2012,1,0,15432,15432
2246,operating,550994,3,01-08-2011,26-09-2013,3,787,15187,15974
2247,operating,14750000,2,13-05-2013,12-05-2014,7,364,15838,16202
2248,operating,20000000,1,04-02-2008,04-02-2008,4,0,13913,13913
2249,operating,132831,2,01-08-2013,01-11-2013,2,92,15918,16010
2250,operating,4000000,2,04-04-2011,01-02-2012,2,303,15068,15371
2251,operating,,1,24-07-2014,24-07-2014,1,0,16275,16275
2252,operating,1020000,4,02-07-2013,10-08-2015,1,769,15888,16657
2253,operating,2000000,1,07-07-2015,07-07-2015,1,0,16623,16623
2254,operating,10243467,2,29-10-2013,10-09-2015,9,681,16007,16688
2255,operating,,1,25-09-2007,25-09-2007,1,0,13781,13781
2256,operating,,1,28-10-2009,28-10-2009,1,0,14545,14545
2257,operating,,1,27-10-2012,27-10-2012,1,0,15640,15640
2258,operating,6570000,4,01-01-2013,03-06-2015,10,883,15706,16589
2259,operating,74447,2,01-10-2013,20-01-2014,2,111,15979,16090
2260,operating,2580850,3,27-02-2014,09-07-2015,9,497,16128,16625
2261,closed,,1,06-07-2015,06-07-2015,1,0,16622,16622
2262,operating,37400000,3,14-09-2010,09-09-2014,6,1456,14866,16322
2263,acquired,1500000,1,01-03-2012,01-03-2012,2,0,15400,15400
2264,operating,591966,3,10-10-2013,31-07-2015,2,659,15988,16647
2265,operating,1800015,2,02-06-2010,07-12-2011,1,553,14762,15315
2266,operating,4657479,3,16-12-2011,23-10-2015,1,1407,15324,16731
2267,operating,20352,1,21-07-2014,21-07-2014,1,0,16272,16272
2268,operating,500000,1,01-05-2014,01-05-2014,1,0,16191,16191
2269,acquired,6500000,2,08-11-2010,12-10-2011,1,338,14921,15259
2270,operating,,1,21-04-2015,21-04-2015,1,0,16546,16546
2271,operating,,1,05-04-2013,05-04-2013,1,0,15800,15800
2272,operating,230337,4,01-08-2013,01-04-2015,4,608,15918,16526
2273,operating,,1,25-02-2014,25-02-2014,1,0,16126,16126
2274,operating,4500000,2,18-12-2009,22-05-2014,2,1616,14596,16212
2275,closed,163000,1,26-01-2012,26-01-2012,1,0,15365,15365
2276,acquired,17800000,1,15-03-2010,15-03-2010,1,0,14683,14683
2277,operating,125000,2,01-05-2014,29-12-2014,3,242,16191,16433
2278,operating,1625000,1,13-04-2015,13-04-2015,7,0,16538,16538
2279,operating,4976700,1,16-04-2014,16-04-2014,1,0,16176,16176
2280,acquired,15650000,3,10-05-2006,24-04-2008,4,715,13278,13993
2281,operating,,1,01-01-2012,01-01-2012,1,0,15340,15340
2282,closed,22000000,2,03-10-2002,14-12-2005,8,1168,11963,13131
2283,operating,23000000,3,21-10-2014,07-10-2015,11,351,16364,16715
2284,operating,,1,20-12-2012,20-12-2012,1,0,15694,15694
2285,operating,315000,2,01-06-2011,17-05-2013,1,716,15126,15842
2286,operating,1520352,3,31-05-2013,21-07-2014,1,416,15856,16272
2287,operating,343554,2,15-05-2015,12-08-2015,3,89,16570,16659
2288,operating,1878595,2,01-01-2012,01-02-2014,2,762,15340,16102
2289,operating,21500000,2,06-11-2006,27-02-2007,7,113,13458,13571
2290,operating,13410901,2,04-01-2012,09-03-2012,1,65,15343,15408
2291,operating,4030,2,01-10-2013,01-10-2013,2,0,15979,15979
2292,operating,75000,1,05-08-2014,05-08-2014,3,0,16287,16287
2293,operating,2706380.292,1,12-06-2015,12-06-2015,2,0,16598,16598
2294,operating,20000000,1,30-11-1999,30-11-1999,3,0,10925,10925
2295,closed,,1,01-11-2013,01-11-2013,1,0,16010,16010
2296,operating,53000000,4,14-12-2009,11-08-2014,11,1701,14592,16293
2297,operating,3475000,3,16-07-2013,20-03-2015,4,612,15902,16514
2298,ipo,68239769,4,01-09-2000,01-07-2010,12,3590,11201,14791
2299,operating,,1,01-01-2012,01-01-2012,1,0,15340,15340
2300,operating,260000,3,01-09-2014,01-06-2015,5,273,16314,16587
2301,acquired,2500000,2,19-12-2011,20-03-2013,4,457,15327,15784
2302,operating,50000,1,01-05-2009,01-05-2009,1,0,14365,14365
2303,operating,500000,1,01-07-2013,01-07-2013,1,0,15887,15887
2304,operating,14400000,3,15-10-2010,22-11-2013,7,1134,14897,16031
2305,operating,310000,2,01-06-2012,01-11-2013,1,518,15492,16010
2306,operating,600000,1,01-01-2012,01-01-2012,2,0,15340,15340
2307,operating,4000000,2,06-09-2011,12-02-2012,1,159,15223,15382
2308,operating,1800000,1,19-10-2015,19-10-2015,6,0,16727,16727
2309,operating,12000000,3,01-01-2012,05-10-2015,2,1373,15340,16713
2310,operating,5220000,1,23-03-2005,23-03-2005,4,0,12865,12865
2311,operating,2000000,2,01-01-2011,18-09-2014,1,1356,14975,16331
2312,operating,165000,1,19-02-2013,19-02-2013,1,0,15755,15755
2313,operating,13800000,2,16-12-2014,05-05-2015,19,140,16420,16560
2314,operating,1142911,2,10-01-2012,15-10-2014,3,1009,15349,16358
2315,ipo,4900000,2,17-06-2014,01-10-2014,2,106,16238,16344
2316,operating,30000,1,01-03-2015,01-03-2015,1,0,16495,16495
2317,acquired,12000000,1,15-11-2002,15-11-2002,2,0,12006,12006
2318,operating,293000000,1,11-11-2013,11-11-2013,1,0,16020,16020
2319,operating,,1,04-03-2014,04-03-2014,1,0,16133,16133
2320,operating,2175016,1,23-03-2015,23-03-2015,2,0,16517,16517
2321,acquired,4400000,2,30-09-2004,31-07-2007,1,1034,12691,13725
2322,operating,10000,1,17-10-2013,17-10-2013,1,0,15995,15995
2323,operating,2285554,1,01-10-2014,01-10-2014,4,0,16344,16344
2324,operating,,1,15-03-2015,15-03-2015,1,0,16509,16509
2325,acquired,7760000,5,26-04-2007,07-02-2011,7,1383,13629,15012
2326,operating,,2,10-01-2013,01-09-2014,2,599,15715,16314
2327,operating,292432833,1,10-11-2014,10-11-2014,1,0,16384,16384
2328,operating,8616975.442,1,16-11-2015,16-11-2015,5,0,16755,16755
2329,closed,75321,1,01-11-2014,01-11-2014,1,0,16375,16375
2330,operating,120000000,1,26-11-2015,26-11-2015,1,0,16765,16765
2331,closed,13400000,1,22-05-2013,22-05-2013,2,0,15847,15847
2332,operating,9760000,1,17-10-2014,17-10-2014,2,0,16360,16360
2333,closed,1200000,1,26-06-2012,26-06-2012,9,0,15517,15517
2334,closed,2700000,1,05-06-2015,05-06-2015,4,0,16591,16591
2335,operating,1300000,1,12-11-2015,12-11-2015,4,0,16751,16751
2336,operating,210000,1,01-06-2011,01-06-2011,1,0,15126,15126
2337,operating,280000,1,01-10-2008,01-10-2008,1,0,14153,14153
2338,operating,,2,15-06-2015,08-10-2015,3,115,16601,16716
2339,acquired,2500000,1,01-10-2003,01-10-2003,2,0,12326,12326
2340,operating,,1,25-03-2014,25-03-2014,2,0,16154,16154
2341,closed,2180048,5,25-03-2013,31-12-2013,5,281,15789,16070
2342,operating,2000000,1,18-11-2015,18-11-2015,5,0,16757,16757
2343,operating,46271386,3,07-05-2009,08-06-2015,5,2223,14371,16594
2344,operating,900000,2,12-11-2008,01-02-2010,4,446,14195,14641
2345,operating,8443200,1,27-01-2010,27-01-2010,2,0,14636,14636
2346,operating,100000,1,10-10-2014,10-10-2014,2,0,16353,16353
2347,operating,50000,1,10-09-2014,10-09-2014,1,0,16323,16323
2348,operating,2950000,3,01-04-2015,16-11-2015,2,229,16526,16755
2349,operating,4200000,3,08-11-2011,31-08-2015,10,1392,15286,16678
2350,closed,23000000,1,05-03-2000,05-03-2000,7,0,11021,11021
2351,acquired,48600,1,20-10-2010,20-10-2010,1,0,14902,14902
2352,acquired,13500000,2,01-01-2007,09-12-2008,7,708,13514,14222
2353,operating,100000000,1,11-02-2014,11-02-2014,1,0,16112,16112
2354,operating,125000,1,01-04-2013,01-04-2013,1,0,15796,15796
2355,operating,1500000,1,29-03-2006,29-03-2006,2,0,13236,13236
2356,operating,75000,1,01-04-2010,01-04-2010,1,0,14700,14700
2357,operating,4000000,3,18-02-2011,01-10-2013,2,956,15023,15979
2358,operating,,1,01-01-2012,01-01-2012,1,0,15340,15340
2359,operating,2100000,1,05-10-2006,05-10-2006,3,0,13426,13426
2360,acquired,,1,01-01-2008,01-01-2008,5,0,13879,13879
2361,ipo,23910000,2,06-02-2006,08-04-2008,7,792,13185,13977
2362,operating,,1,01-05-2008,01-05-2008,1,0,14000,14000
2363,operating,,1,28-06-2012,28-06-2012,1,0,15519,15519
2364,operating,3758835,2,01-12-2013,04-03-2015,5,458,16040,16498
2365,closed,9251000,3,05-08-2011,12-08-2015,6,1468,15191,16659
2366,operating,27730000,2,09-07-2007,23-06-2008,9,350,13703,14053
2367,operating,1384222,7,01-07-2012,07-01-2014,6,555,15522,16077
2368,operating,39900000,4,01-07-2011,13-07-2015,25,1473,15156,16629
2369,operating,,2,21-02-2011,15-02-2013,2,725,15026,15751
2370,operating,4807100,3,01-01-2008,18-01-2012,3,1478,13879,15357
2371,operating,,1,20-11-2013,20-11-2013,3,0,16029,16029
2372,operating,26000000,4,01-02-2003,08-06-2006,11,1223,12084,13307
2373,operating,,1,01-09-2009,01-09-2009,1,0,14488,14488
2374,acquired,,1,02-03-2010,02-03-2010,1,0,14670,14670
2375,operating,,1,01-01-2009,01-01-2009,1,0,14245,14245
2376,operating,3738338,1,19-06-2014,19-06-2014,1,0,16240,16240
2377,operating,17300000,1,23-07-2007,23-07-2007,4,0,13717,13717
2378,acquired,20000000,1,19-11-2012,19-11-2012,5,0,15663,15663
2379,operating,,1,01-08-2012,01-08-2012,1,0,15553,15553
2380,operating,,,,,,,,
2381,acquired,9200000,2,01-09-2005,28-10-2007,2,787,13027,13814
2382,operating,25000,1,13-02-2015,13-02-2015,1,0,16479,16479
2383,operating,5000000,1,22-07-2015,22-07-2015,4,0,16638,16638
2384,operating,18000000,3,24-11-2009,11-12-2013,4,1478,14572,16050
2385,acquired,,1,01-05-2004,01-05-2004,1,0,12539,12539
2386,acquired,20000,1,01-09-2011,01-09-2011,1,0,15218,15218
2387,acquired,1250000,1,01-11-2013,01-11-2013,2,0,16010,16010
2388,closed,,1,10-07-2015,10-07-2015,1,0,16626,16626
2389,acquired,16000000,2,01-02-2000,23-09-2002,4,965,10988,11953
2390,operating,,1,01-11-2013,01-11-2013,1,0,16010,16010
2391,operating,153499,1,20-04-2013,20-04-2013,1,0,15815,15815
2392,operating,,1,21-10-2011,21-10-2011,1,0,15268,15268
2393,operating,1347305,1,19-03-2014,19-03-2014,3,0,16148,16148
2394,operating,6250000,3,09-06-2011,21-05-2014,13,1077,15134,16211
2395,operating,1075000,2,01-06-2011,25-09-2013,2,847,15126,15973
2396,operating,67100000,3,04-12-2002,01-01-2008,18,1854,12025,13879
2397,operating,250000,2,25-11-2014,13-09-2015,6,292,16399,16691
2398,closed,25000,1,01-07-2009,01-07-2009,1,0,14426,14426
2399,closed,30000,1,01-02-2015,01-02-2015,1,0,16467,16467
2400,operating,,1,24-02-2014,24-02-2014,1,0,16125,16125
2401,operating,55232200,3,01-01-2007,24-10-2012,11,2123,13514,15637
2402,operating,,1,01-01-2013,01-01-2013,1,0,15706,15706
2403,operating,13900000,3,01-10-2012,01-02-2015,17,853,15614,16467
2404,operating,,1,29-04-2014,29-04-2014,2,0,16189,16189
2405,operating,13100000,4,01-12-2010,23-09-2014,8,1392,14944,16336
2406,operating,3500000,2,01-01-2014,29-10-2014,14,301,16071,16372
2407,operating,,1,11-09-2013,11-09-2013,1,0,15959,15959
2408,operating,117394,2,01-07-2012,01-08-2012,3,31,15522,15553
2409,operating,11795700,1,19-12-2007,19-12-2007,4,0,13866,13866
2410,operating,90000,5,15-05-2012,15-07-2013,4,426,15475,15901
2411,operating,28400000,6,10-10-2006,21-10-2011,9,1837,13431,15268
2412,acquired,11988175.72,2,20-12-2006,15-09-2009,4,1000,13502,14502
2413,operating,639000,2,10-07-2006,31-10-2008,2,844,13339,14183
2414,operating,400000,1,27-04-2015,27-04-2015,3,0,16552,16552
2415,operating,1110531,1,30-06-2015,30-06-2015,4,0,16616,16616
2416,operating,950000,1,15-07-2014,15-07-2014,3,0,16266,16266
2417,operating,5301059,1,07-01-2013,07-01-2013,4,0,15712,15712
2418,operating,3646260,2,31-10-2008,01-03-2010,4,486,14183,14669
2419,operating,5000000,1,09-04-2014,09-04-2014,2,0,16169,16169
2420,acquired,52500000,4,01-01-2005,25-04-2008,13,1210,12784,13994
2421,operating,5316630,4,07-03-2006,27-07-2015,1,3429,13214,16643
2422,operating,4848804,1,16-12-2013,16-12-2013,1,0,16055,16055
2423,operating,5400000,1,13-11-2014,13-11-2014,1,0,16387,16387
2424,acquired,3000000,1,31-03-2003,31-03-2003,2,0,12142,12142
2425,operating,10000000,1,10-09-2015,10-09-2015,2,0,16688,16688
2426,operating,785366,1,07-02-2013,07-02-2013,1,0,15743,15743
2427,operating,16200000,1,27-06-2006,27-06-2006,1,0,13326,13326
2428,closed,145000,1,23-08-2012,23-08-2012,1,0,15575,15575
2429,operating,100000,1,27-01-2014,27-01-2014,3,0,16097,16097
2430,operating,5798482,6,03-10-2007,18-07-2014,7,2480,13789,16269
2431,operating,7237193,7,01-11-2010,17-04-2015,5,1628,14914,16542
2432,operating,,2,28-03-2013,13-03-2014,1,350,15792,16142
2433,operating,,1,10-12-2013,10-12-2013,1,0,16049,16049
2434,operating,40000000,1,09-01-2014,09-01-2014,1,0,16079,16079
2435,ipo,85870000,7,24-03-2006,01-12-2014,27,3174,13231,16405
2436,operating,8842094,2,08-01-2012,24-03-2013,11,441,15347,15788
2437,operating,120000,1,01-12-2014,01-12-2014,2,0,16405,16405
2438,operating,10000000,2,01-02-2014,20-08-2014,4,200,16102,16302
2439,closed,39702320.82,1,13-12-2006,13-12-2006,1,0,13495,13495
2440,acquired,90000000,2,04-05-2004,01-03-2007,9,1031,12542,13573
2441,acquired,4650000,2,01-05-2001,01-05-2002,6,365,11443,11808
2442,operating,5000000,1,12-11-2014,12-11-2014,1,0,16386,16386
2443,operating,3000000,2,17-09-2013,01-08-2015,10,683,15965,16648
2444,operating,690819.6905,3,01-07-2014,01-09-2015,3,427,16252,16679
2445,operating,5000,1,05-11-2013,05-11-2013,1,0,16014,16014
2446,operating,27804097,3,01-01-2007,01-02-2011,3,1492,13514,15006
2447,operating,1925548,1,10-02-2011,10-02-2011,1,0,15015,15015
2448,operating,75000,1,01-09-2008,01-09-2008,2,0,14123,14123
2449,operating,2000000,1,01-01-2007,01-01-2007,4,0,13514,13514
2450,acquired,18628333,4,30-06-2010,21-11-2012,14,875,14790,15665
2451,acquired,50653283,6,20-12-2006,13-01-2012,11,1850,13502,15352
2452,operating,6446217,4,22-10-2010,03-09-2013,1,1047,14904,15951
2453,acquired,,1,01-07-1998,01-07-1998,1,0,10408,10408
2454,operating,11615514,3,09-12-2009,05-08-2014,3,1700,14587,16287
2455,operating,,1,09-07-2007,09-07-2007,2,0,13703,13703
2456,operating,1000000,1,23-12-2014,23-12-2014,2,0,16427,16427
2457,operating,4313980,4,31-01-2012,05-12-2014,1,1039,15370,16409
2458,operating,15820000,1,14-06-2006,14-06-2006,1,0,13313,13313
2459,operating,5000000,1,07-08-2007,07-08-2007,2,0,13732,13732
2460,acquired,56000000,2,06-10-2005,28-06-2007,16,630,13062,13692
2461,acquired,8750000,1,11-07-2005,11-07-2005,3,0,12975,12975
2462,operating,28365200,4,25-06-2012,04-09-2014,3,801,15516,16317
2463,ipo,21800000,4,06-07-2007,13-11-2015,3,3052,13700,16752
2464,operating,49488,1,31-01-2014,31-01-2014,1,0,16101,16101
2465,operating,40000,1,10-04-2012,10-04-2012,1,0,15440,15440
2466,operating,72900000,7,01-01-2007,21-04-2015,21,3032,13514,16546
2467,operating,51732700,3,16-06-2009,02-10-2013,23,1569,14411,15980
2468,operating,1325000,4,06-06-2011,03-10-2014,3,1215,15131,16346
2469,operating,6200000,3,16-09-2013,27-03-2015,14,557,15964,16521
2470,operating,6700000,2,28-01-2013,29-09-2014,5,609,15733,16342
2471,acquired,12000000,1,16-05-2005,16-05-2005,3,0,12919,12919
2472,operating,126619,3,01-01-2012,16-04-2012,3,106,15340,15446
2473,operating,100000,1,12-02-2014,12-02-2014,1,0,16113,16113
2474,operating,2005950,1,08-04-2007,08-04-2007,1,0,13611,13611
2475,operating,7500000,2,01-07-2014,30-06-2015,4,364,16252,16616
2476,operating,514793,1,24-01-2014,24-01-2014,1,0,16094,16094
2477,operating,250000,1,24-02-2014,24-02-2014,1,0,16125,16125
2478,operating,,1,01-01-2012,01-01-2012,1,0,15340,15340
2479,closed,7100,2,01-04-2009,01-01-2010,2,275,14335,14610
2480,operating,11900000,3,16-08-2011,28-11-2012,21,470,15202,15672
2481,operating,49600000,5,14-10-2002,19-07-2010,23,2835,11974,14809
2482,operating,41250,1,01-12-2014,01-12-2014,1,0,16405,16405
2483,operating,1700000,1,20-09-2006,20-09-2006,1,0,13411,13411
2484,operating,2000000,1,08-07-2015,08-07-2015,1,0,16624,16624
2485,operating,,1,13-05-2015,13-05-2015,1,0,16568,16568
2486,closed,2000000,1,19-01-2010,19-01-2010,2,0,14628,14628
2487,closed,,1,05-02-2001,05-02-2001,1,0,11358,11358
2488,operating,3000000,3,01-12-2012,04-09-2014,2,642,15675,16317
2489,acquired,,1,01-01-2007,01-01-2007,1,0,13514,13514
2490,acquired,49300000,3,26-09-2002,10-02-2005,13,868,11956,12824
2491,operating,17340000,4,01-05-2013,05-05-2015,20,734,15826,16560
2492,operating,18878570,3,01-01-2012,21-08-2013,5,598,15340,15938
2493,operating,,1,01-01-2011,01-01-2011,3,0,14975,14975
2494,operating,126457,1,01-10-2014,01-10-2014,1,0,16344,16344
2495,operating,500000,2,13-06-2008,03-12-2008,2,173,14043,14216
2496,operating,5836950,2,02-12-2013,17-06-2015,4,562,16041,16603
2497,operating,8970000,1,12-01-2009,12-01-2009,1,0,14256,14256
2498,operating,75000000,1,24-09-2010,24-09-2010,1,0,14876,14876
2499,closed,5000000,1,30-03-2015,30-03-2015,1,0,16524,16524
2500,operating,150040,3,22-05-2012,01-03-2013,3,283,15482,15765
2501,operating,,1,14-06-2000,14-06-2000,1,0,11122,11122
2502,operating,757625,1,03-10-2013,03-10-2013,2,0,15981,15981
2503,acquired,3000000,1,01-01-2010,01-01-2010,2,0,14610,14610
2504,closed,1050000,1,28-02-2013,28-02-2013,1,0,15764,15764
2505,operating,150000,1,05-11-2015,05-11-2015,1,0,16744,16744
2506,operating,2000000,1,19-10-2015,19-10-2015,1,0,16727,16727
2507,acquired,4788800,1,09-02-2006,09-02-2006,1,0,13188,13188
2508,operating,25000,1,16-07-2014,16-07-2014,1,0,16267,16267
2509,operating,,1,18-02-2015,18-02-2015,1,0,16484,16484
2510,operating,65000000,2,21-10-2014,23-06-2015,8,245,16364,16609
2511,operating,67000510,10,03-04-2007,04-09-2015,9,3076,13606,16682
2512,operating,10963000,3,01-02-2006,19-05-2009,5,1203,13180,14383
2513,operating,43720,1,05-06-2011,05-06-2011,1,0,15130,15130
2514,operating,,1,27-10-2015,27-10-2015,1,0,16735,16735
2515,acquired,5000000,1,10-10-2013,10-10-2013,4,0,15988,15988
2516,closed,40000,1,15-10-2015,15-10-2015,1,0,16723,16723
2517,acquired,2050000,2,12-08-2008,24-04-2009,1,255,14103,14358
2518,operating,235000,2,01-04-2012,01-07-2012,2,91,15431,15522
2519,operating,650000,2,22-09-2014,15-10-2014,2,23,16335,16358
2520,operating,460000,1,26-06-2012,26-06-2012,1,0,15517,15517
2521,operating,25000,1,10-02-2012,10-02-2012,2,0,15380,15380
2522,operating,60699922,4,29-04-2008,13-04-2015,5,2540,13998,16538
2523,operating,144000000,2,03-06-2013,02-07-2013,2,29,15859,15888
2524,operating,18000000,1,02-07-2003,02-07-2003,1,0,12235,12235
2525,operating,1200000,1,02-04-2012,02-04-2012,3,0,15432,15432
2526,operating,4000000,1,15-12-2005,15-12-2005,1,0,13132,13132
2527,acquired,3700000,1,19-06-2013,19-06-2013,1,0,15875,15875
2528,closed,,1,01-06-2010,01-06-2010,1,0,14761,14761
2529,operating,4400000,1,19-06-2013,19-06-2013,1,0,15875,15875
2530,operating,,1,24-03-2004,24-03-2004,1,0,12501,12501
2531,acquired,4000000,1,01-01-2006,01-01-2006,2,0,13149,13149
2532,operating,14000000,1,08-01-2004,08-01-2004,4,0,12425,12425
2533,closed,7240000,4,11-11-2010,21-06-2011,6,222,14924,15146
2534,operating,94000,1,21-01-2014,21-01-2014,1,0,16091,16091
2535,operating,6100000,1,01-08-2006,01-08-2006,1,0,13361,13361
2536,operating,483687225,8,01-08-2008,22-07-2015,45,2546,14092,16638
2537,operating,,3,31-07-1999,01-12-2012,3,4872,10803,15675
2538,operating,,1,12-08-2014,12-08-2014,2,0,16294,16294
2539,acquired,45100000,3,13-08-2001,01-06-2003,13,657,11547,12204
2540,operating,220000000,6,07-02-2010,29-04-2015,9,1907,14647,16554
2541,operating,,1,01-10-2014,01-10-2014,1,0,16344,16344
2542,acquired,,1,02-11-1999,02-11-1999,2,0,10897,10897
2543,operating,450000,1,09-09-2014,09-09-2014,1,0,16322,16322
2544,operating,2000000,1,28-03-2008,28-03-2008,2,0,13966,13966
2545,acquired,3496222,6,01-07-2009,01-07-2013,6,1461,14426,15887
2546,operating,7848830,4,24-06-2009,01-08-2012,1,1134,14419,15553
2547,operating,19330001,4,03-05-2007,19-12-2012,4,2057,13636,15693
2548,acquired,,2,01-03-2009,01-11-2009,5,245,14304,14549
2549,acquired,6500000,1,01-02-2000,01-02-2000,2,0,10988,10988
2550,operating,,1,22-01-2014,22-01-2014,1,0,16092,16092
2551,operating,20000000,1,22-12-2014,22-12-2014,2,0,16426,16426
2552,operating,1000000,2,09-04-2015,27-07-2015,3,109,16534,16643
2553,operating,3000000,2,01-06-2013,09-06-2015,1,738,15857,16595
2554,acquired,525000,3,12-11-2012,22-08-2013,2,283,15656,15939
2555,operating,,1,13-08-2009,13-08-2009,1,0,14469,14469
2556,operating,25202754.93,2,01-02-2015,18-11-2015,1,290,16467,16757
2557,operating,11465645,4,11-09-2012,27-03-2014,5,562,15594,16156
2558,operating,1601493,1,24-07-2015,24-07-2015,1,0,16640,16640
2559,operating,43000000,1,07-06-2009,07-06-2009,1,0,14402,14402
2560,operating,,1,20-05-2011,20-05-2011,2,0,15114,15114
2561,operating,,1,12-06-2013,12-06-2013,2,0,15868,15868
2562,operating,30214,1,01-11-2004,01-11-2004,1,0,12723,12723
2563,closed,18885,1,01-07-2012,01-07-2012,1,0,15522,15522
2564,operating,,1,18-05-2011,18-05-2011,1,0,15112,15112
2565,operating,117500,1,16-01-2008,16-01-2008,1,0,13894,13894
2566,operating,42000000,3,24-07-2008,15-08-2012,11,1483,14084,15567
2567,operating,2800000,2,20-05-2013,03-11-2014,2,532,15845,16377
2568,operating,452836,3,06-09-2013,22-05-2014,1,258,15954,16212
2569,operating,26550000,6,01-01-2006,19-12-2013,6,2909,13149,16058
2570,operating,,1,01-09-2014,01-09-2014,1,0,16314,16314
2571,closed,,1,07-01-2015,07-01-2015,1,0,16442,16442
2572,operating,,1,19-07-2012,19-07-2012,1,0,15540,15540
2573,operating,48451,1,01-10-2012,01-10-2012,1,0,15614,15614
2574,acquired,42477641,2,08-02-2005,20-07-2009,1,1623,12822,14445
2575,acquired,14020000,2,12-09-2005,12-12-2006,5,456,13038,13494
2576,operating,3200000,2,19-12-2011,04-09-2012,3,260,15327,15587
2577,operating,,1,22-08-2011,22-08-2011,1,0,15208,15208
2578,operating,10000000,1,07-10-2013,07-10-2013,1,0,15985,15985
2579,operating,6000000,1,10-02-2015,10-02-2015,3,0,16476,16476
2580,operating,1240000,3,20-08-2014,08-05-2015,4,261,16302,16563
2581,operating,325000,2,26-03-2014,17-12-2014,2,266,16155,16421
2582,operating,1000000,2,20-11-2013,14-11-2014,2,359,16029,16388
2583,operating,1152531.81,2,01-07-2014,06-11-2015,1,493,16252,16745
2584,operating,,2,15-11-2011,14-05-2013,4,546,15293,15839
2585,operating,41250,1,01-07-2014,01-07-2014,1,0,16252,16252
2586,operating,,1,01-07-2011,01-07-2011,1,0,15156,15156
2587,operating,39200000,3,15-11-2011,25-03-2015,10,1226,15293,16519
2588,operating,1000000,1,23-02-2015,23-02-2015,2,0,16489,16489
2589,operating,15000000,1,16-11-2015,16-11-2015,1,0,16755,16755
2590,operating,6662526,6,07-07-2011,16-10-2013,1,832,15162,15994
2591,operating,1800000,2,01-04-2013,30-04-2014,3,394,15796,16190
2592,operating,,1,20-06-2014,20-06-2014,1,0,16241,16241
2593,acquired,5000000,1,30-12-2003,30-12-2003,3,0,12416,12416
2594,operating,34726279,7,01-01-2005,20-06-2014,19,3457,12784,16241
2595,acquired,20000000,1,24-08-2010,24-08-2010,1,0,14845,14845
2596,operating,,1,02-04-2013,02-04-2013,5,0,15797,15797
2597,operating,10871040,1,07-01-2010,07-01-2010,1,0,14616,14616
2598,operating,59059340.59,3,07-08-2007,11-09-2014,12,2592,13732,16324
2599,operating,,1,01-02-2014,01-02-2014,1,0,16102,16102
2600,acquired,4940000,2,01-09-2004,14-11-2007,6,1169,12662,13831
2601,operating,10000000,1,26-07-2010,26-07-2010,1,0,14816,14816
2602,operating,24900000,1,29-06-2015,29-06-2015,3,0,16615,16615
2603,ipo,181040191,4,08-01-2004,15-10-2012,2,3203,12425,15628
2604,closed,4000000,1,04-04-2004,04-04-2004,1,0,12512,12512
2605,operating,,1,20-10-2015,20-10-2015,1,0,16728,16728
2606,operating,40000000,4,01-01-2005,17-03-2010,9,1901,12784,14685
2607,operating,18833000,3,10-07-2013,15-06-2015,13,705,15896,16601
2608,operating,2000000,1,20-05-2014,20-05-2014,5,0,16210,16210
2609,acquired,13000000,1,23-06-2013,23-06-2013,2,0,15879,15879
2610,operating,794109,1,26-07-2013,26-07-2013,1,0,15912,15912
2611,operating,5972500,3,01-02-2007,01-01-2011,4,1430,13545,14975
2612,operating,172500000,3,22-04-2005,20-09-2006,2,516,12895,13411
2613,operating,,2,03-07-2014,07-04-2015,5,278,16254,16532
2614,operating,41500000,1,18-04-2008,18-04-2008,3,0,13987,13987
2615,operating,,1,01-01-2014,01-01-2014,1,0,16071,16071
2616,operating,100000,1,19-07-2013,19-07-2013,1,0,15905,15905
2617,operating,9400000,2,22-11-2013,26-11-2014,17,369,16031,16400
2618,operating,7750000,1,01-02-2000,01-02-2000,2,0,10988,10988
2619,operating,46889878,4,07-03-2007,18-02-2011,6,1444,13579,15023
2620,ipo,86401577,8,30-12-2003,15-09-2011,2,2816,12416,15232
2621,operating,16200000,4,01-10-2012,10-04-2014,12,556,15614,16170
2622,operating,120000,1,01-12-2014,01-12-2014,1,0,16405,16405
2623,operating,25000,1,01-12-2013,01-12-2013,1,0,16040,16040
2624,operating,15923277,2,01-01-2014,10-04-2015,6,464,16071,16535
2625,operating,,1,02-07-2013,02-07-2013,1,0,15888,15888
2626,operating,113500000,3,07-06-2010,06-10-2015,4,1947,14767,16714
2627,operating,4660480,2,01-09-2008,01-11-2013,2,1887,14123,16010
2628,operating,4400000,1,03-10-2011,03-10-2011,1,0,15250,15250
2629,closed,8247532,5,05-06-2009,24-01-2014,2,1694,14400,16094
2630,operating,,1,01-04-2012,01-04-2012,5,0,15431,15431
2631,operating,50000,1,01-03-2014,01-03-2014,1,0,16130,16130
2632,operating,32929912,4,06-04-2010,19-10-2015,2,2022,14705,16727
2633,operating,6000000,2,01-10-2014,20-11-2015,1,415,16344,16759
2634,operating,28426456,8,28-01-2009,24-04-2015,6,2277,14272,16549
2635,operating,164744,1,01-02-2014,01-02-2014,1,0,16102,16102
2636,acquired,500000,1,24-09-2009,24-09-2009,1,0,14511,14511
2637,operating,93000000,4,01-09-2007,25-03-2014,5,2397,13757,16154
2638,operating,450000,1,03-09-2015,03-09-2015,2,0,16681,16681
2639,operating,1000000,1,17-08-2014,17-08-2014,2,0,16299,16299
2640,closed,6000000,1,01-09-2012,01-09-2012,1,0,15584,15584
2641,operating,,1,01-09-2008,01-09-2008,1,0,14123,14123
2642,operating,,3,07-12-2012,04-09-2014,11,636,15681,16317
2643,closed,,1,07-09-2015,07-09-2015,1,0,16685,16685
2644,operating,2600000,2,13-08-2012,15-12-2013,6,489,15565,16054
2645,operating,1600000,1,08-02-2008,08-02-2008,1,0,13917,13917
2646,operating,25090000,1,31-03-2008,31-03-2008,1,0,13969,13969
2647,closed,6760000,2,18-02-2010,01-04-2012,3,773,14658,15431
2648,operating,50000,1,10-12-2009,10-12-2009,1,0,14588,14588
2649,acquired,28932322,4,10-11-2010,11-09-2012,8,671,14923,15594
2650,operating,,1,13-04-2015,13-04-2015,1,0,16538,16538
2651,operating,4750000,2,18-03-2014,17-12-2014,2,274,16147,16421
2652,closed,32676154,4,26-05-2009,24-01-2013,3,1339,14390,15729
2653,operating,840000,1,26-02-2015,26-02-2015,2,0,16492,16492
2654,operating,7500000,2,09-10-2014,20-11-2015,4,407,16352,16759
2655,operating,,1,07-02-2014,07-02-2014,3,0,16108,16108
2656,operating,104791,2,01-09-2010,01-06-2014,1,1369,14853,16222
2657,operating,150000,2,04-12-2013,18-03-2015,4,469,16043,16512
2658,operating,5000000,2,23-10-2013,14-05-2014,2,203,16001,16204
2659,operating,20000000,1,30-07-2001,30-07-2001,5,0,11533,11533
2660,closed,1150000,2,09-05-2009,01-09-2010,8,480,14373,14853
2661,operating,38500000,3,13-01-2004,09-06-2006,7,878,12430,13308
2662,closed,20659,1,06-11-2011,06-11-2011,1,0,15284,15284
2663,operating,,2,30-09-2013,11-03-2014,1,162,15978,16140
2664,closed,18885,2,01-06-2011,01-07-2012,1,396,15126,15522
2665,operating,3000000,2,02-06-2010,30-08-2012,1,820,14762,15582
2666,operating,8000000,1,20-03-2014,20-03-2014,1,0,16149,16149
2667,operating,,1,31-12-2013,31-12-2013,1,0,16070,16070
2668,operating,125000,1,15-08-2012,15-08-2012,1,0,15567,15567
2669,operating,215000,1,01-07-2006,01-07-2006,1,0,13330,13330
2670,closed,,1,15-05-2014,15-05-2014,1,0,16205,16205
2671,closed,17704186,3,28-09-2010,29-10-2012,7,762,14880,15642
2672,operating,1500000,1,23-03-2015,23-03-2015,1,0,16517,16517
2673,closed,,1,10-01-2003,10-01-2003,2,0,12062,12062
2674,operating,40000,1,25-07-2011,25-07-2011,1,0,15180,15180
2675,operating,278088,1,07-05-2014,07-05-2014,6,0,16197,16197
2676,operating,34107,1,01-09-2013,01-09-2013,1,0,15949,15949
2677,operating,20000,1,02-02-2015,02-02-2015,1,0,16468,16468
2678,operating,1000000,1,27-01-2015,27-01-2015,6,0,16462,16462
2679,operating,12700000,1,14-08-2014,14-08-2014,4,0,16296,16296
2680,operating,3500000,1,17-10-2013,17-10-2013,1,0,15995,15995
2681,operating,11000000,1,29-07-2005,29-07-2005,2,0,12993,12993
2682,operating,79700000,5,28-04-2011,23-09-2014,10,1244,15092,16336
2683,closed,150000,1,01-01-2007,01-01-2007,2,0,13514,13514
2684,ipo,136911999,3,01-09-2000,17-01-2012,4,4155,11201,15356
2685,operating,870000,1,31-07-2014,31-07-2014,1,0,16282,16282
2686,acquired,3500000,1,29-06-1999,29-06-1999,1,0,10771,10771
2687,operating,43106,1,01-12-2014,01-12-2014,1,0,16405,16405
2688,operating,20000000,2,06-12-2013,24-07-2014,3,230,16045,16275
2689,operating,400000,2,01-08-2010,01-07-2011,2,334,14822,15156
2690,operating,,2,01-07-2013,19-05-2015,3,687,15887,16574
2691,operating,12500,1,01-08-2015,01-08-2015,1,0,16648,16648
2692,operating,3000000,2,22-02-2012,11-06-2015,1,1205,15392,16597
2693,closed,3000000,1,04-07-2000,04-07-2000,2,0,11142,11142
2694,operating,46500000,1,12-02-2007,12-02-2007,6,0,13556,13556
2695,closed,100000,1,01-01-2011,01-01-2011,1,0,14975,14975
2696,operating,6000000,1,21-08-2014,21-08-2014,1,0,16303,16303
2697,operating,85000,1,22-07-2013,22-07-2013,1,0,15908,15908
2698,operating,532219,3,04-04-2012,06-11-2013,3,581,15434,16015
2699,operating,40000000,1,07-10-2015,07-10-2015,2,0,16715,16715
2700,operating,,1,08-06-2013,08-06-2013,1,0,15864,15864
2701,operating,,1,02-08-2006,02-08-2006,1,0,13362,13362
2702,operating,2200000,1,19-02-2015,19-02-2015,7,0,16485,16485
2703,operating,10700000,3,11-02-2010,09-07-2014,3,1609,14651,16260
2704,operating,2300000,1,01-10-2013,01-10-2013,12,0,15979,15979
2705,operating,20000000,2,01-08-2009,20-12-2012,2,1237,14457,15694
2706,operating,57433301,6,08-02-2008,22-05-2015,5,2660,13917,16577
2707,acquired,9560000,3,06-12-2010,03-01-2013,2,759,14949,15708
2708,operating,1800000,2,01-12-2013,01-05-2014,1,151,16040,16191
2709,ipo,120000000,2,21-10-2013,05-10-2014,3,349,15999,16348
2710,acquired,6600000,2,29-11-2008,02-09-2009,1,277,14212,14489
2711,operating,18000,1,06-08-2009,06-08-2009,1,0,14462,14462
2712,closed,73500000,3,03-10-2003,07-09-2007,13,1435,12328,13763
2713,acquired,1000000,1,01-02-2011,01-02-2011,1,0,15006,15006
2714,operating,,1,01-06-2011,01-06-2011,1,0,15126,15126
2715,operating,50000000,1,07-07-2003,07-07-2003,4,0,12240,12240
2716,acquired,,1,08-07-2013,08-07-2013,1,0,15894,15894
2717,acquired,62750000,8,01-01-1999,01-11-2005,11,2496,10592,13088
2718,operating,,1,01-09-2013,01-09-2013,1,0,15949,15949
2719,operating,765527,2,08-01-2014,14-02-2014,6,37,16078,16115
2720,operating,4000000,1,05-03-2003,05-03-2003,3,0,12116,12116
2721,operating,25000,1,15-06-2014,15-06-2014,1,0,16236,16236
2722,operating,4000000,1,09-04-2015,09-04-2015,2,0,16534,16534
2723,acquired,,1,20-02-2004,20-02-2004,1,0,12468,12468
2724,operating,503000,2,09-01-2014,21-03-2014,1,71,16079,16150
2725,operating,119881,2,01-04-2012,01-07-2013,3,456,15431,15887
2726,operating,,1,01-09-2008,01-09-2008,1,0,14123,14123
2727,operating,14415734,2,15-07-2013,27-06-2015,2,712,15901,16613
2728,operating,,1,01-08-2008,01-08-2008,1,0,14092,14092
2729,acquired,20300000,3,02-03-2004,27-05-2008,9,1547,12479,14026
2730,closed,70599032.79,1,01-12-2005,01-12-2005,1,0,13118,13118
2731,operating,250000,1,01-06-2008,01-06-2008,2,0,14031,14031
2732,acquired,200000,2,01-06-2012,01-05-2013,1,334,15492,15826
2733,operating,22470400,3,01-10-2012,12-01-2015,16,833,15614,16447
2734,operating,6500000,4,01-01-2009,15-01-2015,1,2205,14245,16450
2735,closed,3452941,3,25-10-2010,21-12-2011,2,422,14907,15329
2736,operating,17100000,3,08-10-2013,02-09-2014,2,329,15986,16315
2737,acquired,,2,30-11-2007,20-04-2008,3,142,13847,13989
2738,operating,1800000,1,04-04-2014,04-04-2014,1,0,16164,16164
2739,operating,607934,1,22-07-2012,22-07-2012,1,0,15543,15543
2740,operating,4920000,2,22-08-2005,31-01-2006,6,162,13017,13179
2741,operating,30000000,1,06-08-2014,06-08-2014,1,0,16288,16288
2742,closed,915000000,1,16-10-2000,16-10-2000,1,0,11246,11246
2743,operating,447883,1,09-09-2015,09-09-2015,1,0,16687,16687
2744,operating,20000,1,01-05-2014,01-05-2014,1,0,16191,16191
2745,operating,14225000,3,01-11-2011,22-05-2014,10,933,15279,16212
2746,operating,470000,1,23-09-2013,23-09-2013,1,0,15971,15971
2747,operating,,1,11-02-2015,11-02-2015,1,0,16477,16477
2748,operating,,1,01-01-2010,01-01-2010,1,0,14610,14610
2749,closed,120000,1,01-01-2008,01-01-2008,2,0,13879,13879
2750,operating,,2,22-01-2014,03-06-2015,1,497,16092,16589
2751,operating,89200000,7,29-08-2003,08-07-2015,16,4331,12293,16624
2752,operating,,2,17-02-2014,15-02-2015,4,363,16118,16481
2753,closed,50000,1,01-01-2012,01-01-2012,1,0,15340,15340
2754,operating,1100000,1,01-09-2010,01-09-2010,1,0,14853,14853
2755,operating,16000000,3,25-06-2014,10-02-2015,5,230,16246,16476
2756,operating,8100000,1,25-01-2010,25-01-2010,1,0,14634,14634
2757,acquired,500000,1,01-12-2013,01-12-2013,1,0,16040,16040
2758,operating,2100000,4,30-12-2010,22-05-2012,11,509,14973,15482
2759,operating,,2,01-07-2011,05-04-2012,3,279,15156,15435
2760,acquired,,1,24-08-2010,24-08-2010,1,0,14845,14845
2761,operating,,1,01-02-2013,01-02-2013,1,0,15737,15737
2762,closed,15670000,4,06-05-2010,12-08-2013,2,1194,14735,15929
2763,operating,410000,1,31-03-2014,31-03-2014,1,0,16160,16160
2764,operating,,1,01-02-2011,01-02-2011,1,0,15006,15006
2765,operating,1199994,1,26-01-2015,26-01-2015,5,0,16461,16461
2766,operating,253001.5144,4,01-02-2014,01-08-2015,4,546,16102,16648
2767,operating,23600000,3,01-05-2012,24-10-2014,9,906,15461,16367
2768,operating,,2,02-03-2015,11-03-2015,1,9,16496,16505
2769,closed,4000000,1,03-08-2006,03-08-2006,2,0,13363,13363
2770,acquired,26000000,1,02-08-1999,02-08-1999,2,0,10805,10805
2771,operating,2374979,6,01-07-2011,09-03-2015,9,1347,15156,16503
2772,operating,100000,1,01-11-2014,01-11-2014,1,0,16375,16375
2773,operating,2726459,1,28-04-2015,28-04-2015,3,0,16553,16553
2774,operating,33500000,2,27-03-2012,08-05-2014,7,772,15426,16198
2775,operating,23010301.04,4,21-07-2011,08-10-2015,5,1540,15176,16716
2776,operating,34010000,3,11-01-2005,07-09-2007,12,969,12794,13763
2777,operating,171420,1,30-05-2011,30-05-2011,3,0,15124,15124
2778,operating,,2,18-10-2013,01-09-2015,8,683,15996,16679
2779,acquired,2500000,2,14-03-2011,06-03-2012,4,358,15047,15405
2780,operating,1000000,3,14-11-2012,01-08-2013,7,260,15658,15918
2781,operating,1000000,2,13-06-2014,01-12-2014,1,171,16234,16405
2782,operating,5000,1,10-09-2010,10-09-2010,1,0,14862,14862
2783,operating,2519440,7,01-06-2012,07-09-2015,4,1193,15492,16685
2784,operating,600000,2,28-08-2014,19-09-2014,5,22,16310,16332
2785,closed,11500000,2,02-03-2005,29-03-2006,3,392,12844,13236
2786,operating,3710000,1,01-09-2010,01-09-2010,1,0,14853,14853
2787,ipo,297263531,8,03-08-2005,07-08-2013,28,2926,12998,15924
2788,closed,,1,15-09-2004,15-09-2004,1,0,12676,12676
2789,operating,82230000,2,01-10-2005,13-09-2007,15,712,13057,13769
2790,operating,11140000,1,01-07-2008,01-07-2008,1,0,14061,14061
2791,acquired,566000000,4,28-03-2007,20-03-2012,3,1819,13600,15419
2792,operating,,2,01-08-2013,01-12-2015,2,852,15918,16770
2793,operating,2241305,4,22-05-2012,01-09-2014,12,832,15482,16314
2794,operating,,2,01-11-2012,01-01-2013,3,61,15645,15706
2795,operating,,1,14-01-2009,14-01-2009,2,0,14258,14258
2796,operating,205510,1,01-03-2014,01-03-2014,1,0,16130,16130
2797,closed,1500000,2,13-06-2005,01-12-2007,2,901,12947,13848
2798,operating,3535000,4,24-12-2012,30-01-2015,5,767,15698,16465
2799,operating,5000000,1,30-08-2011,30-08-2011,2,0,15216,15216
2800,operating,20000,1,01-06-2013,01-06-2013,1,0,15857,15857
2801,closed,1200000,1,10-09-2009,10-09-2009,2,0,14497,14497
2802,operating,25000,1,10-03-2015,10-03-2015,1,0,16504,16504
2803,operating,5300000,2,12-09-2014,24-08-2015,6,346,16325,16671
2804,acquired,122000000,4,27-05-2009,04-10-2012,10,1226,14391,15617
2805,operating,1500000,1,25-11-2013,25-11-2013,9,0,16034,16034
2806,operating,,2,01-10-2005,01-01-2011,2,1918,13057,14975
2807,closed,3000000,1,18-12-2008,18-12-2008,4,0,14231,14231
2808,operating,4089000,5,30-11-2012,12-06-2015,5,924,15674,16598
2809,operating,16176000,6,16-09-2010,26-06-2014,10,1379,14868,16247
2810,operating,500000,1,01-04-2013,01-04-2013,1,0,15796,15796
2811,operating,,1,08-10-2012,08-10-2012,1,0,15621,15621
2812,operating,5997205,5,13-07-2011,25-06-2015,11,1443,15168,16611
2813,operating,447000,1,24-01-2006,24-01-2006,1,0,13172,13172
2814,closed,209000,1,02-11-2007,02-11-2007,1,0,13819,13819
2815,operating,,1,01-01-2014,01-01-2014,1,0,16071,16071
2816,operating,1400000,2,04-04-2014,18-03-2015,2,348,16164,16512
2817,operating,412000000,6,01-02-2011,23-11-2015,15,1756,15006,16762
2818,ipo,,1,01-12-2009,01-12-2009,1,0,14579,14579
2819,operating,5503144,1,01-11-2011,01-11-2011,1,0,15279,15279
2820,operating,176000,2,06-06-2012,20-08-2013,2,440,15497,15937
2821,acquired,29000000,1,15-06-2010,15-06-2010,7,0,14775,14775
2822,operating,3260675,1,11-12-2009,11-12-2009,1,0,14589,14589
2823,ipo,248700000,7,03-11-2010,30-06-2014,4,1335,14916,16251
2824,acquired,19119999,3,16-05-2006,12-03-2008,3,666,13284,13950
2825,operating,10000000,2,31-05-2011,26-10-2011,6,148,15125,15273
2826,operating,,2,08-11-2012,09-01-2013,1,62,15652,15714
2827,acquired,42000000,4,16-06-2004,25-11-2013,11,3449,12585,16034
2828,operating,15100000,4,01-06-2013,28-04-2014,39,331,15857,16188
2829,closed,20000,1,24-08-2015,24-08-2015,1,0,16671,16671
2830,operating,10000,1,01-01-2014,01-01-2014,1,0,16071,16071
2831,operating,3000000,1,12-08-2008,12-08-2008,1,0,14103,14103
2832,operating,40000,1,01-12-2011,01-12-2011,1,0,15309,15309
2833,operating,33400000,3,10-10-2004,28-09-2010,4,2179,12701,14880
2834,operating,4900000,9,23-11-2000,27-06-2013,15,4599,11284,15883
2835,operating,375000,1,21-07-2011,21-07-2011,1,0,15176,15176
2836,operating,4383764,5,01-07-2007,01-02-2013,4,2042,13695,15737
2837,operating,5500000,2,26-06-2013,17-08-2015,7,782,15882,16664
2838,operating,10200000,2,07-03-2011,05-09-2013,7,913,15040,15953
2839,closed,4000000,1,20-03-2008,20-03-2008,1,0,13958,13958
2840,operating,120000,1,01-05-2014,01-05-2014,5,0,16191,16191
2841,operating,2650000,3,01-04-2011,05-06-2013,10,796,15065,15861
2842,closed,38500000,4,01-05-2011,13-04-2014,11,1078,15095,16173
2843,operating,765320,1,17-03-2014,17-03-2014,2,0,16146,16146
2844,operating,534701,4,01-05-2013,01-06-2014,4,396,15826,16222
2845,acquired,,2,07-06-2012,22-04-2013,4,319,15498,15817
2846,operating,2100000,1,07-07-2014,07-07-2014,5,0,16258,16258
2847,operating,270645,1,01-04-2011,01-04-2011,1,0,15065,15065
2848,operating,100000,1,07-01-2014,07-01-2014,1,0,16077,16077
2849,ipo,23000000,1,15-12-1999,15-12-1999,10,0,10940,10940
2850,operating,320000,2,01-01-2008,31-07-2015,1,2768,13879,16647
2851,operating,22621063,1,22-02-2011,22-02-2011,1,0,15027,15027
2852,operating,2000000,1,01-12-2013,01-12-2013,3,0,16040,16040
2853,operating,941764,2,01-07-2013,08-01-2015,2,556,15887,16443
2854,operating,2652724,1,01-11-2005,01-11-2005,1,0,13088,13088
2855,operating,32206,1,01-06-2013,01-06-2013,1,0,15857,15857
2856,ipo,118000000,4,01-01-2005,03-10-2013,13,3197,12784,15981
2857,operating,161987,1,01-01-2013,01-01-2013,1,0,15706,15706
2858,operating,12000000,1,03-12-2014,03-12-2014,3,0,16407,16407
2859,closed,3160000,1,10-06-2008,10-06-2008,4,0,14040,14040
2860,operating,,1,01-02-2014,01-02-2014,1,0,16102,16102
2861,operating,6000000,2,01-10-2011,06-08-2013,2,675,15248,15923
2862,operating,1157500,6,01-11-2012,25-09-2014,19,693,15645,16338
2863,operating,97500000,5,28-02-1999,04-12-2000,10,645,10650,11295
2864,operating,2381617,2,01-06-2008,01-08-2011,1,1156,14031,15187
2865,closed,7500,1,14-10-2014,14-10-2014,1,0,16357,16357
2866,operating,20000000,1,24-06-2008,24-06-2008,1,0,14054,14054
2867,operating,10748830,2,01-04-2003,01-01-2004,2,275,12143,12418
2868,operating,,3,01-10-2009,26-11-2013,1,1517,14518,16035
2869,operating,31400000,6,01-01-2008,10-07-2012,30,1652,13879,15531
2870,operating,,1,24-12-2013,24-12-2013,1,0,16063,16063
2871,operating,650000,1,12-07-2011,12-07-2011,6,0,15167,15167
2872,operating,20000000,1,01-03-2008,01-03-2008,1,0,13939,13939
2873,operating,2857456,2,01-12-2012,01-01-2014,2,396,15675,16071
2874,operating,99498,2,01-12-2011,01-09-2014,2,1005,15309,16314
2875,operating,2091000,1,19-12-2008,19-12-2008,1,0,14232,14232
2876,closed,,1,01-12-2010,01-12-2010,1,0,14944,14944
2877,operating,28000000,1,21-10-2014,21-10-2014,1,0,16364,16364
2878,acquired,6000000,1,01-02-2006,01-02-2006,1,0,13180,13180
2879,operating,241061,1,11-07-2011,11-07-2011,2,0,15166,15166
2880,operating,,1,18-03-2011,18-03-2011,1,0,15051,15051
2881,acquired,,2,01-01-2008,01-06-2009,8,517,13879,14396
2882,operating,25000,1,21-11-2012,21-11-2012,1,0,15665,15665
2883,operating,,3,17-04-2007,01-10-2014,4,2724,13620,16344
2884,acquired,38000000,2,20-12-2002,11-03-2004,10,447,12041,12488
2885,operating,102500,2,15-07-2015,14-10-2015,3,91,16631,16722
2886,operating,,1,01-06-2008,01-06-2008,1,0,14031,14031
2887,operating,52723,1,28-08-2014,28-08-2014,1,0,16310,16310
2888,acquired,40000000,1,16-10-2002,16-10-2002,6,0,11976,11976
2889,operating,46759287,4,06-05-2009,15-11-2012,1,1289,14370,15659
2890,operating,10000,1,01-05-2013,01-05-2013,1,0,15826,15826
2891,acquired,3500000,2,01-04-2005,01-05-2006,11,395,12874,13269
2892,operating,250000,1,05-06-2015,05-06-2015,3,0,16591,16591
2893,operating,,1,18-08-2014,18-08-2014,1,0,16300,16300
2894,operating,,1,01-01-2012,01-01-2012,1,0,15340,15340
2895,operating,4200000,1,01-06-2007,01-06-2007,3,0,13665,13665
2896,operating,42000000,1,01-01-2008,01-01-2008,2,0,13879,13879
2897,closed,5750000,2,04-08-2010,18-01-2011,2,167,14825,14992
2898,acquired,754000,1,26-06-2006,26-06-2006,2,0,13325,13325
2899,operating,1500000,1,17-01-2011,17-01-2011,1,0,14991,14991
2900,closed,,1,03-12-1999,03-12-1999,1,0,10928,10928
2901,operating,,2,01-01-2011,01-06-2011,6,151,14975,15126
2902,operating,95648700,4,30-01-2012,30-03-2015,26,1155,15369,16524
2903,operating,12000,1,10-09-2009,10-09-2009,1,0,14497,14497
2904,operating,3700000,3,05-10-2012,01-07-2015,4,999,15618,16617
2905,operating,2500000,1,13-09-2010,13-09-2010,1,0,14865,14865
2906,operating,3293750,1,01-02-2012,01-02-2012,1,0,15371,15371
2907,operating,494561,2,01-08-2013,01-11-2014,3,457,15918,16375
2908,operating,,1,26-08-2015,26-08-2015,1,0,16673,16673
2909,closed,9000000,2,01-04-2006,01-02-2008,4,671,13239,13910
2910,operating,,1,20-04-2015,20-04-2015,1,0,16545,16545
2911,operating,269169,1,27-08-2013,27-08-2013,1,0,15944,15944
2912,operating,100000,1,13-06-2011,13-06-2011,5,0,15138,15138
2913,operating,,1,31-08-2012,31-08-2012,1,0,15583,15583
2914,operating,2800000,1,09-12-2014,09-12-2014,7,0,16413,16413
2915,operating,1750000,2,01-06-2007,24-07-2007,3,53,13665,13718
2916,operating,40859,1,02-06-2014,02-06-2014,1,0,16223,16223
2917,operating,17400000,4,01-09-2011,31-01-2013,20,518,15218,15736
2918,operating,,1,25-04-2014,25-04-2014,1,0,16185,16185
2919,operating,39226649,4,26-03-2009,30-05-2012,8,1161,14329,15490
2920,operating,,1,10-12-2014,10-12-2014,18,0,16414,16414
2921,operating,9700000,2,11-12-2014,01-10-2015,6,294,16415,16709
2922,acquired,1800000,1,03-10-2013,03-10-2013,9,0,15981,15981
2923,operating,1440000,4,15-11-2012,17-12-2014,2,762,15659,16421
2924,operating,40000,1,16-12-2011,16-12-2011,1,0,15324,15324
2925,operating,,1,01-11-2013,01-11-2013,1,0,16010,16010
2926,closed,20500000,1,16-10-2000,16-10-2000,2,0,11246,11246
2927,operating,,1,01-01-2013,01-01-2013,1,0,15706,15706
2928,operating,12500000,1,16-07-2014,16-07-2014,1,0,16267,16267
2929,acquired,9120018,2,25-04-2007,13-08-2009,1,841,13628,14469
2930,operating,2290000,1,10-09-2010,10-09-2010,1,0,14862,14862
2931,closed,7499994,2,29-06-2009,12-07-2010,1,378,14424,14802
2932,operating,2000000,1,11-11-2014,11-11-2014,3,0,16385,16385
2933,operating,643300,1,16-01-2014,16-01-2014,6,0,16086,16086
2934,operating,270862,1,12-06-2014,12-06-2014,1,0,16233,16233
2935,operating,21935000,4,09-05-2011,23-12-2014,6,1324,15103,16427
2936,closed,,1,28-02-1997,28-02-1997,1,0,9920,9920
2937,operating,3120673,2,13-11-2014,18-11-2014,4,5,16387,16392
2938,operating,,1,20-12-2013,20-12-2013,1,0,16059,16059
2939,operating,,1,01-01-2006,01-01-2006,1,0,13149,13149
2940,operating,20161,1,01-02-2013,01-02-2013,1,0,15737,15737
2941,closed,1398000,5,07-07-2011,26-02-2014,11,965,15162,16127
2942,acquired,18000000,1,13-08-2013,13-08-2013,2,0,15930,15930
2943,operating,20000,1,01-05-2013,01-05-2013,1,0,15826,15826
2944,closed,900000,1,28-08-2006,28-08-2006,1,0,13388,13388
2945,operating,55000000,2,12-06-2007,10-08-2011,4,1520,13676,15196
2946,operating,800000,1,02-06-2015,02-06-2015,5,0,16588,16588
2947,operating,14390000,5,18-10-2012,17-11-2014,25,760,15631,16391
2948,operating,1000000,1,01-07-2014,01-07-2014,1,0,16252,16252
2949,operating,301531,4,01-05-2012,01-07-2014,4,791,15461,16252
2950,operating,385790,1,14-09-2015,14-09-2015,1,0,16692,16692
2951,operating,,1,07-05-2014,07-05-2014,1,0,16197,16197
2952,operating,884500,1,31-12-2011,31-12-2011,1,0,15339,15339
2953,operating,34390435,9,05-05-2002,19-11-2012,7,3851,11812,15663
2954,operating,6000000,2,10-04-2013,14-02-2014,2,310,15805,16115
2955,operating,4640000,1,30-06-2008,30-06-2008,1,0,14060,14060
2956,operating,5858102,3,07-12-2011,10-06-2015,1,1281,15315,16596
2957,operating,107867,2,23-08-2013,02-12-2013,3,101,15940,16041
2958,operating,2000000,1,03-06-2015,03-06-2015,2,0,16589,16589
2959,operating,8148255,2,30-11-2011,13-10-2014,1,1048,15308,16356
2960,closed,500000,1,01-01-2013,01-01-2013,4,0,15706,15706
2961,operating,12000000,1,12-08-2008,12-08-2008,1,0,14103,14103
2962,operating,100000,1,20-04-2007,20-04-2007,1,0,13623,13623
2963,operating,638380,1,13-01-2015,13-01-2015,2,0,16448,16448
2964,operating,40000,1,16-12-2013,16-12-2013,1,0,16055,16055
2965,acquired,9000000,2,01-04-2008,26-06-2009,4,451,13970,14421
2966,ipo,47232377,5,24-02-2011,29-08-2014,5,1282,15029,16311
2967,operating,,2,01-09-2011,01-08-2012,9,335,15218,15553
2968,operating,1000000,1,01-07-2014,01-07-2014,1,0,16252,16252
2969,closed,435953,4,10-02-2009,12-06-2010,1,487,14285,14772
2970,operating,,1,01-12-2012,01-12-2012,1,0,15675,15675
2971,operating,,1,20-05-2015,20-05-2015,1,0,16575,16575
2972,operating,,1,07-09-2012,07-09-2012,1,0,15590,15590
2973,operating,,1,25-07-2013,25-07-2013,1,0,15911,15911
2974,operating,4750000,4,16-09-2014,17-06-2015,8,274,16329,16603
2975,operating,925000,3,20-04-2010,16-05-2013,1,1122,14719,15841
2976,acquired,5800000,2,01-01-2007,18-03-2009,2,807,13514,14321
2977,acquired,,1,07-07-2013,07-07-2013,1,0,15893,15893
2978,closed,12300000,2,27-10-2006,16-07-2010,7,1358,13448,14806
2979,operating,675529,1,01-02-2014,01-02-2014,1,0,16102,16102
2980,operating,64758,1,01-11-2012,01-11-2012,1,0,15645,15645
2981,closed,253194,2,01-10-2010,29-03-2011,1,179,14883,15062
2982,operating,8000000,2,01-12-2006,03-05-2007,5,153,13483,13636
2983,operating,,1,01-10-2013,01-10-2013,1,0,15979,15979
2984,operating,117112117,1,01-12-2014,01-12-2014,1,0,16405,16405
2985,ipo,158688887,9,15-11-2007,03-02-2015,11,2637,13832,16469
2986,operating,2000000,1,30-10-2012,30-10-2012,6,0,15643,15643
2987,operating,12500,1,01-07-2014,01-07-2014,1,0,16252,16252
2988,operating,34000000,3,10-02-2011,21-09-2011,8,223,15015,15238
2989,operating,2227000,4,20-12-2010,15-05-2014,1,1242,14963,16205
2990,operating,4464259,2,01-12-2000,01-06-2003,2,912,11292,12204
2991,operating,30500000,2,05-03-2001,02-07-2004,6,1215,11386,12601
2992,operating,1800000,2,31-05-2014,09-11-2015,8,527,16221,16748
2993,operating,35345,2,31-07-2009,01-04-2010,1,244,14456,14700
2994,operating,50676045,5,11-08-2008,31-01-2014,3,1999,14102,16101
2995,operating,150000,2,01-06-2013,24-08-2013,1,84,15857,15941
2996,operating,3300000,2,01-04-2014,13-09-2015,5,530,16161,16691
2997,operating,100000,1,30-01-2014,30-01-2014,1,0,16100,16100
2998,operating,30000000,1,01-05-2007,01-05-2007,2,0,13634,13634
2999,operating,25000,1,14-03-2013,14-03-2013,1,0,15778,15778
3000,operating,12500000,1,26-05-2004,26-05-2004,2,0,12564,12564
3001,operating,10000000,1,22-11-2011,22-11-2011,1,0,15300,15300
3002,operating,,1,28-08-2012,28-08-2012,1,0,15580,15580
3003,operating,249304,1,01-07-2014,01-07-2014,1,0,16252,16252
3004,operating,40347,3,01-01-2013,16-12-2013,1,349,15706,16055
3005,acquired,11210000,1,01-06-2006,01-06-2006,5,0,13300,13300
3006,operating,9786,1,19-07-2014,19-07-2014,2,0,16270,16270
3007,operating,12050000,4,01-01-2008,25-06-2012,6,1637,13879,15516
3008,acquired,,3,01-07-2008,31-03-2014,3,2099,14061,16160
3009,acquired,,1,27-03-2002,27-03-2002,1,0,11773,11773
3010,operating,,1,24-10-2013,24-10-2013,1,0,16002,16002
3011,operating,400000,1,08-01-2014,08-01-2014,1,0,16078,16078
3012,operating,,1,01-01-2014,01-01-2014,1,0,16071,16071
3013,operating,3000000,1,03-11-2015,03-11-2015,2,0,16742,16742
3014,operating,,1,08-03-2010,08-03-2010,1,0,14676,14676
3015,operating,237401,1,01-07-2010,01-07-2010,1,0,14791,14791
3016,operating,7500000,1,04-10-2012,04-10-2012,1,0,15617,15617
3017,operating,952601,2,07-01-2013,10-03-2014,2,427,15712,16139
3018,operating,20900000,2,10-04-2014,31-03-2015,6,355,16170,16525
3019,operating,11600000,4,01-01-2008,08-05-2014,6,2319,13879,16198
3020,operating,60000000,1,08-01-2002,08-01-2002,1,0,11695,11695
3021,operating,2700000,2,01-01-2013,01-10-2015,1,1003,15706,16709
3022,acquired,20000000,1,20-11-2007,20-11-2007,2,0,13837,13837
3023,operating,4250000,2,17-02-2004,17-11-2014,5,3926,12465,16391
3024,ipo,28000000,1,23-08-2013,23-08-2013,2,0,15940,15940
3025,acquired,75000000,3,21-05-2003,19-06-2006,15,1125,12193,13318
3026,operating,780000,1,15-04-2013,15-04-2013,1,0,15810,15810
3027,operating,,1,29-03-2013,29-03-2013,1,0,15793,15793
3028,operating,400000,1,03-01-2011,03-01-2011,1,0,14977,14977
3029,operating,277967.0213,2,19-11-2013,25-09-2015,1,675,16028,16703
3030,operating,1342546,1,30-03-2010,30-03-2010,1,0,14698,14698
3031,operating,49407,1,15-06-2014,15-06-2014,1,0,16236,16236
3032,operating,28000000,2,30-11-2012,09-09-2014,7,648,15674,16322
3033,operating,,1,01-01-2007,01-01-2007,2,0,13514,13514
3034,operating,120000000,1,14-09-2015,14-09-2015,8,0,16692,16692
3035,operating,12500,1,01-08-2015,01-08-2015,1,0,16648,16648
3036,operating,2004300,3,01-04-2012,15-11-2013,2,593,15431,16024
3037,operating,600000,1,25-10-2006,25-10-2006,1,0,13446,13446
3038,operating,6950000,4,01-04-2012,25-10-2013,3,572,15431,16003
3039,operating,,1,01-08-2012,01-08-2012,1,0,15553,15553
3040,operating,,1,04-02-2013,04-02-2013,1,0,15740,15740
3041,operating,459272,1,16-05-2013,16-05-2013,1,0,15841,15841
3042,operating,1408000,2,18-02-2015,09-06-2015,27,111,16484,16595
3043,operating,40753400,6,01-12-2009,23-10-2015,6,2152,14579,16731
3044,operating,4000000,1,13-04-2010,13-04-2010,2,0,14712,14712
3045,operating,39520000,4,15-03-2013,13-10-2015,17,942,15779,16721
3046,operating,35792,2,13-02-2014,26-03-2015,3,406,16114,16520
3047,operating,,1,11-05-2010,11-05-2010,1,0,14740,14740
3048,ipo,2180000,2,13-09-2013,06-02-2015,1,511,15961,16472
3049,operating,,1,17-09-2015,17-09-2015,1,0,16695,16695
3050,operating,18800000,5,03-01-2006,05-12-2014,2,3258,13151,16409
3051,operating,2500000,1,07-04-2015,07-04-2015,3,0,16532,16532
3052,operating,3956447,2,19-09-2013,17-03-2015,5,544,15967,16511
3053,operating,120000,1,01-12-2014,01-12-2014,4,0,16405,16405
3054,operating,100000,1,01-12-2013,01-12-2013,2,0,16040,16040
3055,operating,160000,2,13-05-2014,16-07-2014,3,64,16203,16267
3056,operating,100000,1,12-06-2014,12-06-2014,1,0,16233,16233
3057,operating,270862,1,12-06-2014,12-06-2014,1,0,16233,16233
3058,acquired,8100000,1,14-08-2001,14-08-2001,3,0,11548,11548
3059,operating,4297285,5,01-08-2012,11-02-2014,1,559,15553,16112
3060,ipo,80000000,1,16-09-2005,16-09-2005,6,0,13042,13042
3061,operating,85860220,4,20-04-2011,05-02-2015,11,1387,15084,16471
3062,operating,2688237,9,01-09-2009,17-12-2013,2,1568,14488,16056
3063,operating,808211,1,28-10-2013,28-10-2013,3,0,16006,16006
3064,operating,19900000,2,20-02-2006,30-06-2010,5,1591,13199,14790
3065,operating,2000000,2,01-02-2013,02-07-2015,1,881,15737,16618
3066,operating,,1,28-05-2004,28-05-2004,1,0,12566,12566
3067,ipo,,1,10-11-2004,10-11-2004,1,0,12732,12732
3068,operating,4000000,1,28-05-2008,28-05-2008,2,0,14027,14027
3069,operating,,1,01-02-2012,01-02-2012,1,0,15371,15371
3070,operating,5375000,5,26-07-2010,01-12-2013,5,1224,14816,16040
3071,operating,25000,4,26-10-2011,25-02-2014,4,853,15273,16126
3072,operating,15000000,1,15-06-2015,15-06-2015,1,0,16601,16601
3073,operating,11000000,1,24-01-2001,24-01-2001,3,0,11346,11346
3074,operating,14450000,2,16-03-2005,12-11-2009,3,1702,12858,14560
3075,operating,2590393,2,22-10-2012,16-09-2014,2,694,15635,16329
3076,operating,,1,21-02-2013,21-02-2013,1,0,15757,15757
3077,operating,22600000,4,19-09-2005,13-07-2010,10,1758,13045,14803
3078,closed,2500000,1,11-07-2013,11-07-2013,2,0,15897,15897
3079,operating,1500000,1,03-02-2009,03-02-2009,1,0,14278,14278
3080,operating,9740000,5,22-11-2010,04-09-2013,7,1017,14935,15952
3081,operating,50152231,6,01-10-2003,29-05-2013,12,3528,12326,15854
3082,operating,25224241,4,13-01-2010,22-03-2013,1,1164,14622,15786
3083,closed,,1,25-05-2015,25-05-2015,1,0,16580,16580
3084,acquired,33400000,3,09-09-2002,30-08-2005,5,1086,11939,13025
3085,operating,8485408,1,10-12-2013,10-12-2013,1,0,16049,16049
3086,acquired,5000000,1,12-01-2006,12-01-2006,2,0,13160,13160
3087,operating,2100000,2,14-09-2015,10-11-2015,3,57,16692,16749
3088,operating,,1,03-07-2013,03-07-2013,1,0,15889,15889
3089,operating,1000000,1,20-09-2013,20-09-2013,1,0,15968,15968
3090,operating,,1,16-07-2015,16-07-2015,5,0,16632,16632
3091,operating,4500000,1,19-03-2014,19-03-2014,2,0,16148,16148
3092,acquired,17000000,3,18-01-2012,23-04-2014,4,826,15357,16183
3093,operating,237912,1,01-09-2013,01-09-2013,1,0,15949,15949
3094,operating,38999,1,20-12-2012,20-12-2012,1,0,15694,15694
3095,operating,13000000,2,18-05-2012,13-05-2015,1,1090,15478,16568
3096,operating,,1,20-02-2013,20-02-2013,1,0,15756,15756
3097,operating,50000000,1,06-08-2006,06-08-2006,1,0,13366,13366
3098,operating,38979,1,11-12-2012,11-12-2012,1,0,15685,15685
3099,acquired,,3,01-01-2006,10-03-2009,10,1164,13149,14313
3100,operating,2340000,1,27-06-2008,27-06-2008,1,0,14057,14057
3101,acquired,12500000,3,01-02-2005,10-04-2006,7,433,12815,13248
3102,operating,24925000,3,01-09-2013,08-04-2015,7,584,15949,16533
3103,operating,,2,01-01-2013,01-10-2015,2,1003,15706,16709
3104,operating,1259105,1,11-12-2013,11-12-2013,1,0,16050,16050
3105,operating,1107215000,6,01-06-2007,06-04-2014,29,2501,13665,16166
3106,operating,7669424,2,01-04-2012,20-12-2012,2,263,15431,15694
3107,operating,42980577,7,04-01-2012,12-11-2015,4,1408,15343,16751
3108,operating,43000000,1,11-02-2014,11-02-2014,1,0,16112,16112
3109,operating,4700000,2,22-01-2013,14-09-2015,4,965,15727,16692
3110,operating,,1,15-12-2014,15-12-2014,1,0,16419,16419
3111,operating,26250000,1,01-08-2008,01-08-2008,4,0,14092,14092
3112,operating,,2,01-01-2014,08-06-2015,5,523,16071,16594
3113,operating,2590607,5,21-06-2011,07-07-2015,2,1477,15146,16623
3114,operating,34623,1,01-05-2014,01-05-2014,1,0,16191,16191
3115,operating,,1,14-03-2013,14-03-2013,1,0,15778,15778
3116,operating,4500000,1,10-12-2009,10-12-2009,1,0,14588,14588
3117,operating,40000,1,15-03-2013,15-03-2013,1,0,15779,15779
3118,closed,380000,1,23-05-2012,23-05-2012,3,0,15483,15483
3119,ipo,97256127,8,01-06-2005,22-05-2014,23,3277,12935,16212
3120,operating,,1,01-01-2013,01-01-2013,1,0,15706,15706
3121,operating,4470000,1,01-06-2006,01-06-2006,1,0,13300,13300
3122,operating,400000,1,20-06-2014,20-06-2014,3,0,16241,16241
3123,operating,3750000,3,25-07-2013,25-11-2014,2,488,15911,16399
3124,operating,539450,2,28-12-2008,01-05-2010,6,489,14241,14730
3125,operating,6000000,1,02-03-2005,02-03-2005,1,0,12844,12844
3126,operating,3318000,1,29-03-2012,29-03-2012,1,0,15428,15428
3127,operating,1085535,2,15-01-2012,10-12-2013,6,695,15354,16049
3128,operating,1075000,3,10-01-2012,01-06-2014,5,873,15349,16222
3129,acquired,5000000,1,13-01-2004,13-01-2004,1,0,12430,12430
3130,operating,500000,1,12-01-2011,12-01-2011,3,0,14986,14986
3131,operating,7700000,4,01-10-2009,31-12-2010,2,456,14518,14974
3132,operating,1982219,4,26-11-2012,19-02-2014,8,450,15670,16120
3133,operating,,1,31-10-2012,31-10-2012,1,0,15644,15644
3134,closed,34600000,3,16-11-2005,15-09-2008,11,1034,13103,14137
3135,operating,596705,3,25-09-2009,01-11-2011,9,767,14512,15279
3136,operating,25000,1,01-12-2014,01-12-2014,1,0,16405,16405
3137,operating,,1,30-04-2013,30-04-2013,1,0,15825,15825
3138,closed,2814258,1,23-12-2009,23-12-2009,1,0,14601,14601
3139,closed,115000,1,10-04-2010,10-04-2010,1,0,14709,14709
3140,operating,174665,1,01-10-2014,01-10-2014,1,0,16344,16344
3141,operating,14220012,4,25-10-2012,20-03-2015,23,876,15638,16514
3142,operating,,1,26-08-2005,26-08-2005,1,0,13021,13021
3143,operating,300538.9795,1,26-10-2015,26-10-2015,3,0,16734,16734
3144,operating,134680,1,01-04-2010,01-04-2010,1,0,14700,14700
3145,operating,4500000,2,02-01-2008,01-11-2008,4,304,13880,14184
3146,operating,,1,06-01-2015,06-01-2015,1,0,16441,16441
3147,operating,281426,1,01-07-2014,01-07-2014,2,0,16252,16252
3148,operating,53229009,5,01-12-2007,25-03-2015,13,2671,13848,16519
3149,operating,3636603,2,01-03-2008,10-09-2013,3,2019,13939,15958
3150,operating,10750168,4,01-05-2011,28-02-2014,18,1034,15095,16129
3151,operating,3928230,3,21-06-2011,10-04-2012,2,294,15146,15440
3152,acquired,200000,1,09-03-2011,09-03-2011,2,0,15042,15042
3153,operating,555000,3,20-02-2014,09-06-2015,1,474,16121,16595
3154,closed,20000000,1,27-08-2000,27-08-2000,3,0,11196,11196
3155,operating,719427,2,22-01-2013,10-09-2015,1,961,15727,16688
3156,operating,3000000,1,25-08-2014,25-08-2014,1,0,16307,16307
3157,operating,10000000,1,28-05-2013,28-05-2013,1,0,15853,15853
3158,operating,30000,1,24-12-2014,24-12-2014,1,0,16428,16428
3159,operating,227000,1,21-09-2015,21-09-2015,1,0,16699,16699
3160,operating,95127,1,01-03-2015,01-03-2015,1,0,16495,16495
3161,operating,,3,01-02-2012,19-05-2015,10,1203,15371,16574
3162,operating,,1,16-11-2015,16-11-2015,1,0,16755,16755
3163,operating,700000,1,12-10-2015,12-10-2015,1,0,16720,16720
3164,operating,,2,01-05-2014,01-10-2014,2,153,16191,16344
3165,operating,7250000,2,07-12-2006,18-12-2013,2,2568,13489,16057
3166,operating,1178736,1,30-01-2007,30-01-2007,1,0,13543,13543
3167,acquired,44300000,2,02-01-2001,21-01-2004,7,1114,11324,12438
3168,operating,,1,25-02-2013,25-02-2013,1,0,15761,15761
3169,operating,613106,1,13-01-2012,13-01-2012,1,0,15352,15352
3170,operating,5500000,4,30-11-2013,29-01-2015,22,425,16039,16464
3171,acquired,5750095,2,05-08-2009,25-10-2010,4,446,14461,14907
3172,operating,733000,1,23-03-2015,23-03-2015,6,0,16517,16517
3173,operating,880000,1,28-04-2015,28-04-2015,7,0,16553,16553
3174,operating,155000,2,01-12-2010,24-05-2012,1,540,14944,15484
3175,operating,288171856,8,27-12-2007,15-04-2015,21,2666,13874,16540
3176,operating,,2,26-06-2013,15-03-2015,2,627,15882,16509
3177,operating,28751437,1,04-11-2014,04-11-2014,1,0,16378,16378
3178,operating,3500000,2,04-12-2003,27-11-2013,1,3646,12390,16036
3179,closed,1595790,2,01-05-2008,01-01-2009,2,245,14000,14245
3180,operating,4505000,2,12-12-2014,06-01-2015,2,25,16416,16441
3181,operating,,1,01-01-2007,01-01-2007,1,0,13514,13514
3182,operating,52000000,3,02-03-2012,19-06-2014,6,839,15401,16240
3183,operating,80060000,2,16-03-2015,11-08-2015,8,148,16510,16658
3184,operating,150000,1,17-03-2014,17-03-2014,1,0,16146,16146
3185,operating,2630000,1,14-02-2007,14-02-2007,2,0,13558,13558
3186,operating,1000000,1,30-01-2015,30-01-2015,1,0,16465,16465
3187,operating,2000000,1,29-09-2015,29-09-2015,7,0,16707,16707
3188,operating,462157,1,09-07-2014,09-07-2014,3,0,16260,16260
3189,operating,105000,1,23-06-2014,23-06-2014,2,0,16244,16244
3190,operating,69936227,5,12-03-2010,07-04-2014,2,1487,14680,16167
3191,operating,4914999,4,01-01-2008,22-04-2014,4,2303,13879,16182
3192,operating,25000,1,25-10-2012,25-10-2012,1,0,15638,15638
3193,operating,5485431,3,23-04-2008,09-07-2014,5,2268,13992,16260
3194,acquired,7000000,2,20-11-2002,05-07-2005,12,958,12011,12969
3195,acquired,114449379,12,16-05-2001,24-04-2012,30,3996,11458,15454
3196,operating,40000,1,06-02-2012,06-02-2012,1,0,15376,15376
3197,operating,1009404.208,2,18-02-2014,01-02-2015,3,348,16119,16467
3198,operating,3438286,1,20-09-2006,20-09-2006,3,0,13411,13411
3199,operating,10000000,1,16-01-2001,16-01-2001,3,0,11338,11338
3200,operating,45732000,3,25-09-2013,01-04-2015,4,553,15973,16526
3201,operating,2100000,1,10-04-2014,10-04-2014,16,0,16170,16170
3202,operating,40000,1,01-06-2014,01-06-2014,1,0,16222,16222
3203,operating,77034731,7,16-10-2001,22-12-2013,18,4450,11611,16061
3204,operating,3000000,1,03-09-2013,03-09-2013,1,0,15951,15951
3205,operating,210082,2,01-11-2011,01-03-2013,2,486,15279,15765
3206,operating,100000,1,01-06-2014,01-06-2014,1,0,16222,16222
3207,closed,,1,01-03-2012,01-03-2012,1,0,15400,15400
3208,operating,43000000,1,01-04-2008,01-04-2008,1,0,13970,13970
3209,operating,513186,1,04-11-2014,04-11-2014,2,0,16378,16378
3210,closed,23055247,2,05-02-1999,20-11-2002,4,1384,10627,12011
3211,operating,,1,01-09-2011,01-09-2011,1,0,15218,15218
3212,operating,242500000,6,13-03-2008,11-03-2015,41,2554,13951,16505
3213,acquired,11750000,3,25-06-2008,15-03-2010,5,628,14055,14683
3214,operating,1200000,2,03-02-2014,27-05-2015,3,478,16104,16582
3215,operating,35400000,3,24-09-2002,23-11-2011,8,3347,11954,15301
3216,operating,50000,1,01-06-2012,01-06-2012,2,0,15492,15492
3217,operating,1672580,1,05-09-2013,05-09-2013,2,0,15953,15953
3218,operating,8200000,2,04-02-2013,25-11-2015,2,1024,15740,16764
3219,operating,2800000,2,01-11-2012,16-04-2015,10,896,15645,16541
3220,operating,37800000,2,30-03-2015,30-09-2015,2,184,16524,16708
3221,operating,950000,1,09-02-2015,09-02-2015,1,0,16475,16475
3222,operating,150000,1,17-12-2014,17-12-2014,1,0,16421,16421
3223,operating,230000,1,19-01-2013,19-01-2013,1,0,15724,15724
3224,operating,28000000,2,03-09-2014,10-09-2014,2,7,16316,16323
3225,operating,773174,1,13-01-2014,13-01-2014,1,0,16083,16083
3226,closed,,1,12-12-2013,12-12-2013,1,0,16051,16051
3227,operating,20000,1,05-05-2014,05-05-2014,1,0,16195,16195
3228,operating,150000,1,29-05-2013,29-05-2013,2,0,15854,15854
3229,operating,,1,30-09-2015,30-09-2015,1,0,16708,16708
3230,operating,9700000,1,26-07-2005,26-07-2005,6,0,12990,12990
3231,operating,15000,1,27-04-2010,27-04-2010,1,0,14726,14726
3232,acquired,250000,1,07-12-2012,07-12-2012,3,0,15681,15681
3233,operating,251859,3,01-10-2012,01-06-2014,2,608,15614,16222
3234,operating,4000000,1,20-11-2012,20-11-2012,1,0,15664,15664
3235,closed,472000000,1,12-12-2013,12-12-2013,1,0,16051,16051
3236,operating,105000,1,09-10-2013,09-10-2013,2,0,15987,15987
3237,operating,186000000,3,17-09-2013,01-09-2015,10,714,15965,16679
3238,operating,,1,02-04-2015,02-04-2015,2,0,16527,16527
3239,operating,27000000,1,12-02-2015,12-02-2015,1,0,16478,16478
3240,closed,39000000,4,14-06-2005,22-10-2010,9,1956,12948,14904
3241,operating,,1,07-05-2014,07-05-2014,1,0,16197,16197
3242,operating,14294000,3,17-11-2005,13-07-2012,6,2430,13104,15534
3243,closed,9500000,1,21-04-2004,21-04-2004,4,0,12529,12529
3244,operating,500000,1,01-12-2011,01-12-2011,1,0,15309,15309
3245,operating,3923692,1,17-12-2014,17-12-2014,4,0,16421,16421
3246,operating,22500000,1,07-01-2011,07-01-2011,1,0,14981,14981
3247,operating,6000000,1,26-02-2008,26-02-2008,3,0,13935,13935
3248,operating,3000000,1,05-01-2012,05-01-2012,3,0,15344,15344
3249,closed,3050000,3,28-02-2011,07-08-2012,1,526,15033,15559
3250,operating,1575000,3,30-09-2013,27-01-2014,3,119,15978,16097
3251,operating,501937,2,01-05-2014,01-03-2015,1,304,16191,16495
3252,operating,746013,5,01-07-2012,01-12-2013,6,518,15522,16040
3253,operating,10000000,1,11-05-2007,11-05-2007,1,0,13644,13644
3254,operating,3500000,3,01-11-2012,26-12-2014,21,785,15645,16430
3255,operating,6679800,4,08-10-2008,17-07-2013,1,1743,14160,15903
3256,ipo,6700000,1,01-06-1997,01-06-1997,1,0,10013,10013
3257,operating,4000000,1,20-10-2015,20-10-2015,2,0,16728,16728
3258,operating,2830000,1,07-11-2007,07-11-2007,1,0,13824,13824
3259,operating,8680000,2,18-01-2006,01-11-2007,8,652,13166,13818
3260,acquired,80000000,5,01-12-2006,10-07-2012,9,2048,13483,15531
3261,operating,14750000,4,03-03-2012,09-07-2014,6,858,15402,16260
3262,operating,26652027,6,20-03-2009,31-07-2015,2,2324,14323,16647
3263,operating,3410000,2,02-04-2015,02-05-2015,1,30,16527,16557
3264,operating,2606855,2,01-04-2013,01-07-2013,1,91,15796,15887
3265,ipo,10000000,1,16-05-2008,16-05-2008,1,0,14015,14015
3266,acquired,,2,14-02-2011,24-08-2012,2,557,15019,15576
3267,operating,90000,1,01-06-2007,01-06-2007,1,0,13665,13665
3268,acquired,50000000,1,28-09-2001,28-09-2001,1,0,11593,11593
3269,operating,2750000,1,15-01-2015,15-01-2015,10,0,16450,16450
3270,operating,15931,2,01-06-2013,11-04-2015,1,679,15857,16536
3271,operating,,1,01-08-2012,01-08-2012,1,0,15553,15553
3272,operating,,1,20-03-2013,20-03-2013,1,0,15784,15784
3273,acquired,7000000,1,25-10-2005,25-10-2005,4,0,13081,13081
3274,operating,600000,1,03-12-2014,03-12-2014,1,0,16407,16407
3275,operating,,1,09-09-2014,09-09-2014,2,0,16322,16322
3276,operating,3270000,1,19-03-2015,19-03-2015,1,0,16513,16513
3277,closed,,1,08-05-2014,08-05-2014,1,0,16198,16198
3278,operating,10839271,5,06-01-2010,16-02-2015,10,1867,14615,16482
3279,operating,18865204,3,01-04-2013,03-06-2015,3,793,15796,16589
3280,operating,,1,21-12-2012,21-12-2012,2,0,15695,15695
3281,operating,32100000,5,01-09-2010,06-05-2015,26,1708,14853,16561
3282,operating,,1,14-04-2014,14-04-2014,1,0,16174,16174
3283,closed,20000000,1,12-12-1999,12-12-1999,3,0,10937,10937
3284,operating,1596992,2,18-09-2012,21-11-2014,2,794,15601,16395
3285,closed,6000000,1,01-12-2007,01-12-2007,4,0,13848,13848
3286,closed,5000000,1,18-09-2008,18-09-2008,1,0,14140,14140
3287,closed,12951579.97,3,18-06-2007,24-11-2010,4,1255,13682,14937
3288,operating,37397,1,14-04-2010,14-04-2010,1,0,14713,14713
3289,closed,29500000,4,09-07-2009,17-07-2012,6,1104,14434,15538
3290,operating,40000,1,09-02-2012,09-02-2012,1,0,15379,15379
3291,operating,29222,1,01-01-2009,01-01-2009,1,0,14245,14245
3292,operating,75000,1,09-09-2014,09-09-2014,3,0,16322,16322
3293,operating,2000000,1,05-01-2015,05-01-2015,9,0,16440,16440
3294,operating,28000000,2,01-10-2012,24-10-2013,3,388,15614,16002
3295,operating,2000000,2,19-11-2003,09-10-2007,2,1420,12375,13795
3296,operating,8795510,4,16-04-2007,08-08-2012,1,1941,13619,15560
3297,operating,82000000,2,16-07-2013,06-04-2015,2,629,15902,16531
3298,ipo,8000019,2,15-04-2008,06-01-2011,1,996,13984,14980
3299,operating,1339211,2,31-01-2014,24-06-2015,2,509,16101,16610
3300,operating,220000,2,24-09-2013,09-09-2014,1,350,15972,16322
3301,operating,3123210,1,17-07-2015,17-07-2015,2,0,16633,16633
3302,operating,,2,31-03-2015,11-11-2015,1,225,16525,16750
3303,acquired,250000,2,01-01-2012,01-03-2013,2,425,15340,15765
3304,operating,120000,1,01-12-2014,01-12-2014,1,0,16405,16405
3305,operating,1663183,1,25-09-2014,25-09-2014,2,0,16338,16338
3306,closed,50000,1,01-01-2009,01-01-2009,1,0,14245,14245
3307,operating,,1,01-05-2014,01-05-2014,3,0,16191,16191
3308,acquired,10000,1,01-01-2009,01-01-2009,1,0,14245,14245
3309,operating,500000000,1,31-03-2015,31-03-2015,1,0,16525,16525
3310,operating,20000000,1,10-03-2015,10-03-2015,1,0,16504,16504
3311,operating,134900000,6,07-04-2011,06-03-2015,23,1429,15071,16500
3312,acquired,20000000,1,01-03-2001,01-03-2001,1,0,11382,11382
3313,operating,12000000,1,14-12-2009,14-12-2009,2,0,14592,14592
3314,operating,5000000,4,06-11-2013,03-11-2015,4,727,16015,16742
3315,operating,,1,22-07-2013,22-07-2013,1,0,15908,15908
3316,operating,2134000,8,02-03-2012,25-11-2014,8,998,15401,16399
3317,operating,,1,01-02-2011,01-02-2011,1,0,15006,15006
3318,closed,11120000,2,01-04-2006,01-10-2007,5,548,13239,13787
3319,operating,35000,1,14-01-2014,14-01-2014,1,0,16084,16084
3320,operating,31300000,3,28-11-2006,28-09-2010,5,1400,13480,14880
3321,operating,284655,1,17-02-2015,17-02-2015,1,0,16483,16483
3322,operating,5285481,1,01-09-2013,01-09-2013,1,0,15949,15949
3323,operating,6170000,3,01-10-2012,03-03-2015,3,883,15614,16497
3324,closed,794942.1307,1,14-01-2015,14-01-2015,1,0,16449,16449
3325,operating,,1,01-05-2014,01-05-2014,1,0,16191,16191
3326,operating,219000000,4,31-12-2013,20-08-2015,6,597,16070,16667
3327,operating,,1,01-09-2011,01-09-2011,1,0,15218,15218
3328,closed,378995,1,16-01-2015,16-01-2015,2,0,16451,16451
3329,operating,2908200,2,01-06-2008,15-12-2009,1,562,14031,14593
3330,operating,780000,2,15-05-2011,01-08-2013,2,809,15109,15918
3331,operating,15449707,8,01-07-2009,16-04-2015,4,2115,14426,16541
3332,operating,28000,1,10-07-2013,10-07-2013,1,0,15896,15896
3333,closed,8455968.363,1,16-09-2005,16-09-2005,2,0,13042,13042
3334,closed,1500000,1,06-05-2014,06-05-2014,3,0,16196,16196
3335,operating,58000,1,20-01-2015,20-01-2015,1,0,16455,16455
3336,operating,40000,3,23-08-2013,15-02-2015,5,541,15940,16481
3337,operating,112200000,4,20-02-2014,18-06-2015,18,483,16121,16604
3338,operating,,1,06-05-2015,06-05-2015,1,0,16561,16561
3339,operating,62500,1,23-07-2015,23-07-2015,1,0,16639,16639
3340,operating,,1,02-08-2011,02-08-2011,1,0,15188,15188
3341,operating,,1,12-10-2015,12-10-2015,1,0,16720,16720
3342,operating,,1,07-09-2014,07-09-2014,1,0,16320,16320
3343,operating,67000000,2,27-01-2010,12-05-2014,1,1566,14636,16202
3344,operating,200000,1,13-11-2013,13-11-2013,1,0,16022,16022
3345,ipo,8250000,4,18-08-2010,13-08-2013,2,1091,14839,15930
3346,operating,71900000,3,27-10-2010,21-04-2014,29,1272,14909,16181
3347,ipo,53800000,3,19-01-2010,10-02-2014,1,1483,14628,16111
3348,acquired,1250000,1,01-07-2005,01-07-2005,1,0,12965,12965
3349,operating,12500000,1,30-01-2008,30-01-2008,2,0,13908,13908
3350,operating,11500000,1,16-06-2015,16-06-2015,4,0,16602,16602
3351,operating,77500000,2,03-04-2006,23-06-2009,11,1177,13241,14418
3352,operating,1400000,1,20-09-2011,20-09-2011,2,0,15237,15237
3353,operating,7424000,1,22-02-2008,22-02-2008,1,0,13931,13931
3354,operating,14000000,1,22-11-1999,22-11-1999,4,0,10917,10917
3355,operating,30000,1,18-03-2014,18-03-2014,1,0,16147,16147
3356,operating,20000,1,18-07-2014,18-07-2014,1,0,16269,16269
3357,operating,3500000,1,05-11-2015,05-11-2015,3,0,16744,16744
3358,operating,8200000,2,01-12-2010,03-07-2012,4,580,14944,15524
3359,operating,119066,2,01-10-2012,01-10-2012,2,0,15614,15614
3360,closed,,1,01-12-2010,01-12-2010,1,0,14944,14944
3361,ipo,590500000,9,01-11-2009,01-04-2015,39,1977,14549,16526
3362,operating,175000,2,01-05-2008,15-01-2010,1,624,14000,14624
3363,operating,,1,22-06-2015,22-06-2015,9,0,16608,16608
3364,operating,,3,15-12-2011,25-03-2013,6,466,15323,15789
3365,operating,14069797,3,01-10-2008,17-08-2011,1,1050,14153,15203
3366,operating,12000000,1,03-08-2013,03-08-2013,1,0,15920,15920
3367,acquired,4000000,1,11-01-2011,11-01-2011,1,0,14985,14985
3368,operating,2678886,2,01-06-2014,12-12-2014,2,194,16222,16416
3369,closed,5000000,1,01-01-2005,01-01-2005,3,0,12784,12784
3370,operating,14850000,6,28-06-2012,18-02-2015,27,965,15519,16484
3371,operating,1350000,2,05-06-2012,16-03-2015,2,1014,15496,16510
3372,operating,10000000,1,21-04-2014,21-04-2014,1,0,16181,16181
3373,operating,,1,28-06-2014,28-06-2014,1,0,16249,16249
3374,operating,6250000,1,10-09-2007,10-09-2007,1,0,13766,13766
3375,operating,,1,01-04-2011,01-04-2011,1,0,15065,15065
3376,operating,,1,01-10-2009,01-10-2009,3,0,14518,14518
3377,operating,355000000,9,04-03-2012,28-09-2015,29,1303,15403,16706
3378,operating,82974359,5,01-01-2012,09-04-2015,30,1194,15340,16534
3379,operating,456850000,2,01-05-2014,08-07-2015,2,433,16191,16624
3380,operating,145000,2,01-05-2013,11-10-2013,1,163,15826,15989
3381,operating,2000000,1,04-11-2015,04-11-2015,1,0,16743,16743
3382,operating,1000000,1,13-02-2015,13-02-2015,2,0,16479,16479
3383,closed,,1,02-08-2006,02-08-2006,1,0,13362,13362
3384,operating,2775000,4,15-08-2013,22-04-2014,5,250,15932,16182
3385,closed,500000,1,01-07-2009,01-07-2009,2,0,14426,14426
3386,operating,2866335,3,21-12-2007,17-09-2010,3,1001,13868,14869
3387,closed,40000,1,11-10-2012,11-10-2012,1,0,15624,15624
3388,operating,4845795,2,09-12-2010,01-05-2015,1,1604,14952,16556
3389,operating,,1,01-02-2012,01-02-2012,1,0,15371,15371
3390,operating,3986000,2,01-03-2005,27-10-2005,3,240,12843,13083
3391,closed,13150000,2,30-07-2008,15-11-2010,3,838,14090,14928
3392,operating,,1,15-07-2013,15-07-2013,1,0,15901,15901
3393,closed,2500000,1,01-04-2007,01-04-2007,3,0,13604,13604
3394,operating,6150000,2,17-01-2008,01-06-2010,5,866,13895,14761
3395,operating,1500000,1,01-12-2014,01-12-2014,1,0,16405,16405
3396,operating,20000,1,01-01-2014,01-01-2014,1,0,16071,16071
3397,operating,2980000,1,17-08-2007,17-08-2007,1,0,13742,13742
3398,acquired,8500000,3,28-06-2011,01-03-2013,10,612,15153,15765
3399,operating,1600000,1,01-08-2012,01-08-2012,1,0,15553,15553
3400,operating,573614,2,04-07-2013,22-01-2014,4,202,15890,16092
3401,operating,242000,1,14-09-2006,14-09-2006,2,0,13405,13405
3402,operating,1647875,3,01-08-2012,15-07-2014,7,713,15553,16266
3403,operating,,1,08-10-2008,08-10-2008,3,0,14160,14160
3404,operating,500000,2,13-10-2011,01-02-2012,1,111,15260,15371
3405,operating,23700000,3,02-06-2002,14-05-2007,6,1807,11840,13647
3406,operating,28805381,3,05-01-2010,13-03-2012,2,798,14614,15412
3407,closed,1400100,1,12-03-2013,12-03-2013,1,0,15776,15776
3408,closed,500000,2,15-07-2013,29-10-2015,3,836,15901,16737
3409,ipo,96400000,3,04-09-2008,23-07-2012,5,1418,14126,15544
3410,operating,,2,01-01-2014,15-04-2015,1,469,16071,16540
3411,operating,250000,1,10-08-2015,10-08-2015,4,0,16657,16657
3412,operating,,1,01-08-2012,01-08-2012,1,0,15553,15553
3413,operating,,2,03-03-2011,25-09-2015,2,1667,15036,16703
3414,operating,5200000,3,26-11-2012,22-07-2015,9,968,15670,16638
3415,closed,,1,01-03-2015,01-03-2015,1,0,16495,16495
3416,operating,1500000,1,29-10-2014,29-10-2014,1,0,16372,16372
3417,closed,830000,1,27-09-2010,27-09-2010,1,0,14879,14879
3418,acquired,38520000,3,07-02-2003,29-12-2009,21,2517,12090,14607
3419,operating,2600000,1,24-06-2008,24-06-2008,1,0,14054,14054
3420,operating,,1,01-02-2014,01-02-2014,1,0,16102,16102
3421,acquired,12250000,2,01-02-2007,28-07-2008,4,543,13545,14088
3422,operating,1936760,1,05-10-2008,05-10-2008,3,0,14157,14157
3423,acquired,38400000,2,04-08-2000,29-07-2002,11,724,11173,11897
3424,ipo,18100000,4,14-07-2011,05-08-2015,1,1483,15169,16652
3425,operating,12500,1,01-02-2014,01-02-2014,1,0,16102,16102
3426,operating,18500000,4,14-04-2003,28-04-2011,6,2936,12156,15092
3427,acquired,7800000,3,15-12-2009,01-10-2012,7,1021,14593,15614
3428,closed,1300000,2,01-08-2010,01-04-2012,2,609,14822,15431
3429,operating,54000000,3,17-10-2006,15-04-2015,4,3102,13438,16540
3430,closed,,1,29-06-2011,29-06-2011,2,0,15154,15154
3431,operating,625000,1,17-08-2011,17-08-2011,1,0,15203,15203
3432,operating,597375,1,01-05-2009,01-05-2009,5,0,14365,14365
3433,operating,67115160,5,20-02-2006,14-09-2015,15,3493,13199,16692
3434,operating,854343,1,05-05-2007,05-05-2007,2,0,13638,13638
3435,operating,105000,2,01-09-2014,16-09-2015,4,380,16314,16694
3436,closed,6452068,1,25-01-2010,25-01-2010,1,0,14634,14634
3437,operating,21000000,4,15-08-2006,14-02-2014,26,2740,13375,16115
3438,operating,10500000,3,01-01-2011,07-06-2015,9,1618,14975,16593
3439,closed,,3,13-12-2011,12-07-2012,3,212,15321,15533
3440,closed,,1,27-05-2005,27-05-2005,1,0,12930,12930
3441,acquired,35750000,4,01-08-2008,29-01-2013,13,1642,14092,15734
3442,operating,140000,1,01-07-2011,01-07-2011,2,0,15156,15156
3443,operating,5000000,1,06-08-2014,06-08-2014,4,0,16288,16288
3444,operating,120000,1,06-07-2015,06-07-2015,2,0,16622,16622
3445,operating,2570000,4,01-11-2011,25-03-2014,9,875,15279,16154
3446,operating,184235885,5,11-09-2006,26-03-2015,14,3118,13402,16520
3447,operating,1850000,2,10-04-2015,17-09-2015,14,160,16535,16695
3448,operating,6500000,1,25-09-2001,25-09-2001,8,0,11590,11590
3449,acquired,1000000,1,17-07-2013,17-07-2013,4,0,15903,15903
3450,closed,67641704,6,08-09-2006,28-04-2014,9,2789,13399,16188
3451,operating,25000,1,23-01-2013,23-01-2013,2,0,15728,15728
3452,operating,31300000,2,03-11-2010,02-01-2014,1,1156,14916,16072
3453,operating,,1,06-01-2015,06-01-2015,1,0,16441,16441
3454,operating,,1,26-08-2013,26-08-2013,1,0,15943,15943
3455,acquired,10300000,1,19-06-2007,19-06-2007,1,0,13683,13683
3456,operating,8000000,2,01-10-2007,01-05-2008,2,213,13787,14000
3457,operating,,1,21-01-2009,21-01-2009,1,0,14265,14265
3458,operating,5000000,1,29-11-2006,29-11-2006,2,0,13481,13481
3459,ipo,52040000,4,27-04-2007,22-09-2014,6,2705,13630,16335
3460,closed,6850000,2,01-12-2004,13-03-2007,3,832,12753,13585
3461,operating,,2,01-05-2014,28-11-2014,1,211,16191,16402
3462,operating,,1,09-11-2012,09-11-2012,1,0,15653,15653
3463,closed,,1,13-03-2015,13-03-2015,1,0,16507,16507
3464,operating,4000000,2,01-02-2012,12-12-2013,10,680,15371,16051
3465,operating,67893,2,18-09-2013,01-01-2014,2,105,15966,16071
3466,operating,6000000,1,31-07-2007,31-07-2007,2,0,13725,13725
3467,operating,600000,2,16-06-2015,16-06-2015,2,0,16602,16602
3468,operating,515000,2,26-02-2014,20-10-2014,4,236,16127,16363
3469,operating,2674800,1,10-02-2013,10-02-2013,2,0,15746,15746
3470,operating,720000,3,01-05-2014,01-04-2015,1,335,16191,16526
3471,acquired,76000000,4,29-08-2003,24-04-2012,12,3161,12293,15454
3472,operating,2875000,2,26-07-2010,11-05-2011,10,289,14816,15105
3473,closed,381000,1,01-07-2006,01-07-2006,1,0,13330,13330
3474,acquired,6000000,1,01-08-2007,01-08-2007,1,0,13726,13726
3475,operating,7000000,1,04-12-2007,04-12-2007,2,0,13851,13851
3476,operating,,1,27-02-2012,27-02-2012,1,0,15397,15397
3477,operating,2640044,3,01-02-2013,25-07-2014,9,539,15737,16276
3478,operating,175000,2,31-01-2013,03-02-2014,2,368,15736,16104
3479,operating,10000000,1,09-06-2015,09-06-2015,2,0,16595,16595
3480,acquired,,1,07-02-2003,07-02-2003,2,0,12090,12090
3481,acquired,37250000,2,07-01-2002,30-10-2003,6,661,11694,12355
3482,operating,,1,01-05-2013,01-05-2013,1,0,15826,15826
3483,operating,,1,16-02-2015,16-02-2015,1,0,16482,16482
3484,operating,1147000,2,01-07-2014,29-07-2014,1,28,16252,16280
3485,acquired,1000000,1,17-06-2009,17-06-2009,1,0,14412,14412
3486,operating,,1,12-09-2014,12-09-2014,1,0,16325,16325
3487,acquired,2200000,1,12-07-2010,12-07-2010,1,0,14802,14802
3488,ipo,5800000000,1,07-07-2014,07-07-2014,1,0,16258,16258
3489,closed,,1,13-11-2007,13-11-2007,1,0,13830,13830
3490,closed,750000,1,25-01-2012,25-01-2012,2,0,15364,15364
3491,operating,981217,1,16-07-2013,16-07-2013,1,0,15902,15902
3492,operating,1400000,2,11-02-2013,01-04-2014,1,414,15747,16161
3493,operating,,1,05-10-2007,05-10-2007,1,0,13791,13791
3494,operating,797439,3,08-03-2010,16-01-2012,1,679,14676,15355
3495,acquired,5300000,1,05-03-2001,05-03-2001,3,0,11386,11386
3496,operating,18656544,5,01-01-2001,26-03-2015,3,5197,11323,16520
3497,operating,750000,1,01-01-2009,01-01-2009,1,0,14245,14245
3498,operating,1406733,4,09-04-2009,29-11-2011,4,964,14343,15307
3499,operating,14000000,1,15-07-2014,15-07-2014,1,0,16266,16266
3500,operating,3250000,1,24-07-2006,24-07-2006,2,0,13353,13353
3501,operating,17000,1,01-04-2013,01-04-2013,1,0,15796,15796
3502,operating,35000000,1,24-03-2015,24-03-2015,5,0,16518,16518
3503,operating,26174320,2,25-10-2007,29-09-2008,3,340,13811,14151
3504,operating,500000,1,18-06-2010,18-06-2010,1,0,14778,14778
3505,operating,249803.2513,2,12-05-2014,01-10-2014,2,142,16202,16344
3506,acquired,19200000,2,15-05-2001,09-07-2003,15,785,11457,12242
3507,operating,,1,20-12-2011,20-12-2011,1,0,15328,15328
3508,operating,,1,14-06-2012,14-06-2012,2,0,15505,15505
3509,closed,,1,24-01-2008,24-01-2008,1,0,13902,13902
3510,operating,150519,3,01-09-2011,01-08-2013,3,700,15218,15918
3511,acquired,,1,02-04-2010,02-04-2010,2,0,14701,14701
3512,operating,6000000,1,13-04-2010,13-04-2010,1,0,14712,14712
3513,operating,,1,31-03-2004,31-03-2004,1,0,12508,12508
3514,operating,4600000,1,05-08-2009,05-08-2009,2,0,14461,14461
3515,operating,,1,01-01-2013,01-01-2013,2,0,15706,15706
3516,operating,85000000,1,06-11-2015,06-11-2015,1,0,16745,16745
3517,operating,14000000,2,10-01-2001,12-09-2003,7,975,11332,12307
3518,operating,,1,01-08-2010,01-08-2010,1,0,14822,14822
3519,closed,,1,01-03-2011,01-03-2011,1,0,15034,15034
3520,operating,600000,1,16-06-2015,16-06-2015,2,0,16602,16602
3521,operating,50000,2,21-02-2013,07-04-2014,1,410,15757,16167
3522,acquired,22487000,3,01-01-2006,07-05-2008,7,857,13149,14006
3523,operating,1693537,3,01-04-2014,04-12-2015,2,612,16161,16773
3524,operating,,1,16-03-2014,16-03-2014,1,0,16145,16145
3525,operating,,1,01-01-2013,01-01-2013,1,0,15706,15706
3526,operating,3000000,1,07-05-2007,07-05-2007,1,0,13640,13640
3527,operating,723090.6828,3,23-02-2012,05-10-2015,5,1320,15393,16713
3528,operating,147250017,6,21-05-2008,30-10-2015,37,2718,14020,16738
3529,operating,15000,1,01-06-2012,01-06-2012,1,0,15492,15492
3530,operating,4800000,2,01-07-2014,06-08-2015,11,401,16252,16653
3531,ipo,50410400,4,25-10-2006,01-09-2013,2,2503,13446,15949
3532,operating,30000000,1,10-02-2015,10-02-2015,5,0,16476,16476
3533,operating,2000000,2,24-05-2013,16-07-2014,4,418,15849,16267
3534,ipo,50500000,2,14-08-2008,21-09-2010,8,768,14105,14873
3535,operating,33909833,9,29-09-2010,12-06-2013,3,987,14881,15868
3536,operating,,1,18-11-2011,18-11-2011,4,0,15296,15296
3537,operating,30000000,2,26-08-2014,10-11-2015,6,441,16308,16749
3538,operating,10000000,1,06-03-2007,06-03-2007,1,0,13578,13578
3539,operating,909161,1,31-05-2013,31-05-2013,1,0,15856,15856
3540,closed,4950000,1,22-01-2004,22-01-2004,1,0,12439,12439
3541,acquired,,1,11-12-2013,11-12-2013,1,0,16050,16050
3542,operating,16390,1,04-04-2015,04-04-2015,1,0,16529,16529
3543,acquired,,2,01-01-2010,28-08-2010,4,239,14610,14849
3544,operating,,1,28-07-2015,28-07-2015,1,0,16644,16644
3545,operating,4890000,1,10-09-2014,10-09-2014,1,0,16323,16323
3546,operating,93808,1,01-07-2014,01-07-2014,1,0,16252,16252
3547,operating,,1,22-01-2008,22-01-2008,1,0,13900,13900
3548,operating,100000,1,03-08-2015,03-08-2015,1,0,16650,16650
3549,operating,12500000,1,20-03-2012,20-03-2012,1,0,15419,15419
3550,acquired,30240000,3,19-06-2007,17-06-2010,10,1094,13683,14777
3551,operating,2500000,1,27-04-2015,27-04-2015,1,0,16552,16552
3552,closed,8610000,2,20-11-2007,17-03-2010,7,848,13837,14685
3553,operating,,1,06-11-2013,06-11-2013,1,0,16015,16015
3554,acquired,,1,13-02-2004,13-02-2004,1,0,12461,12461
3555,closed,510000000,2,06-07-2010,15-12-2010,5,162,14796,14958
3556,closed,,1,19-12-2014,19-12-2014,2,0,16423,16423
3557,acquired,,1,01-02-2012,01-02-2012,1,0,15371,15371
3558,operating,12000000,5,30-07-2008,01-08-2014,2,2193,14090,16283
3559,closed,8000000,1,01-06-2008,01-06-2008,2,0,14031,14031
3560,operating,212000,1,01-07-2015,01-07-2015,2,0,16617,16617
3561,operating,1000000,1,10-08-2015,10-08-2015,1,0,16657,16657
3562,operating,46255828,9,13-01-2005,11-05-2015,16,3770,12796,16566
3563,operating,,2,09-06-2011,05-09-2014,4,1184,15134,16318
3564,operating,,1,13-01-2014,13-01-2014,1,0,16083,16083
3565,operating,16000000,1,24-01-2001,24-01-2001,5,0,11346,11346
3566,operating,24000000,1,10-08-2015,10-08-2015,1,0,16657,16657
3567,acquired,17459444,2,08-01-2010,05-08-2011,1,574,14617,15191
3568,operating,3660322,2,01-04-2008,01-02-2010,2,671,13970,14641
3569,operating,20000000,1,01-11-2007,01-11-2007,1,0,13818,13818
3570,operating,1200000,2,05-01-2014,15-04-2015,3,465,16075,16540
3571,ipo,12510000,2,01-10-2001,01-01-2002,2,92,11596,11688
3572,operating,11000000,1,14-02-2012,14-02-2012,1,0,15384,15384
3573,closed,5527508,1,24-04-2014,24-04-2014,1,0,16184,16184
3574,operating,8157091,2,10-11-2013,19-06-2015,3,586,16019,16605
3575,acquired,102569484,4,08-01-2007,04-03-2011,12,1516,13521,15037
3576,operating,,1,13-02-2014,13-02-2014,2,0,16114,16114
3577,operating,626076,1,01-08-2012,01-08-2012,2,0,15553,15553
3578,operating,1500000,1,18-01-2008,18-01-2008,1,0,13896,13896
3579,operating,20507.30516,1,20-12-2013,20-12-2013,1,0,16059,16059
3580,ipo,60764825,1,10-05-2013,10-05-2013,1,0,15835,15835
3581,closed,1000000,3,01-01-2008,11-11-2008,4,315,13879,14194
3582,operating,,1,01-04-2012,01-04-2012,1,0,15431,15431
3583,operating,24100000,3,01-09-2005,02-02-2012,5,2345,13027,15372
3584,acquired,,1,15-06-2012,15-06-2012,1,0,15506,15506
3585,closed,5000000,1,10-07-2015,10-07-2015,1,0,16626,16626
3586,acquired,42000000,3,08-03-2004,23-10-2006,14,959,12485,13444
3587,operating,308420,3,01-05-2013,01-02-2015,3,641,15826,16467
3588,acquired,,1,04-03-2004,04-03-2004,3,0,12481,12481
3589,operating,12700000,4,10-06-2011,24-06-2015,11,1475,15135,16610
3590,acquired,44424979,3,20-07-2008,04-01-2013,11,1629,14080,15709
3591,operating,,1,19-02-2009,19-02-2009,1,0,14294,14294
3592,operating,10711500,7,27-05-2009,15-04-2015,3,2149,14391,16540
3593,operating,2500000,1,13-02-2012,13-02-2012,1,0,15383,15383
3594,operating,6055000,3,01-03-2013,08-07-2015,3,859,15765,16624
3595,acquired,6700000,2,19-09-2011,10-09-2013,17,722,15236,15958
3596,acquired,100000,2,01-07-2011,06-09-2011,8,67,15156,15223
3597,closed,813000,4,01-08-2010,15-02-2012,8,563,14822,15385
3598,operating,,1,20-10-2009,20-10-2009,1,0,14537,14537
3599,operating,118000,1,15-06-2015,15-06-2015,1,0,16601,16601
3600,operating,17982000,5,14-11-2008,07-10-2014,12,2153,14197,16350
3601,closed,3008197,2,01-12-2006,08-01-2010,3,1134,13483,14617
3602,operating,700000,1,29-10-2015,29-10-2015,5,0,16737,16737
3603,operating,4500000,1,27-04-2006,27-04-2006,3,0,13265,13265
3604,acquired,37891054,3,12-05-2008,22-12-2010,6,954,14011,14965
3605,operating,,1,12-10-2012,12-10-2012,1,0,15625,15625
3606,operating,,1,01-10-2011,01-10-2011,1,0,15248,15248
3607,operating,1655236,2,01-01-2011,07-08-2014,1,1314,14975,16289
3608,operating,4000000,1,01-10-2013,01-10-2013,3,0,15979,15979
3609,operating,700000,1,08-11-2013,08-11-2013,1,0,16017,16017
3610,operating,1200000,3,02-10-2012,30-07-2014,4,666,15615,16281
3611,closed,2100000,2,01-06-2007,03-03-2008,2,276,13665,13941
3612,operating,,2,01-01-2008,01-04-2013,2,1917,13879,15796
3613,ipo,249099998,5,10-12-2003,07-12-2011,37,2919,12396,15315
3614,operating,10000000,1,10-03-2014,10-03-2014,1,0,16139,16139
3615,closed,50000,1,15-08-2012,15-08-2012,1,0,15567,15567
3616,operating,1836000,3,13-06-2012,28-05-2015,1,1079,15504,16583
3617,operating,4000000,1,28-07-2015,28-07-2015,1,0,16644,16644
3618,closed,242563,1,01-01-2015,01-01-2015,1,0,16436,16436
3619,operating,302883,2,01-01-2010,07-12-2012,1,1071,14610,15681
3620,operating,,1,11-02-2014,11-02-2014,1,0,16112,16112
3621,operating,4850000,2,08-10-2010,22-02-2012,6,502,14890,15392
3622,operating,8500000,1,08-10-2001,08-10-2001,3,0,11603,11603
3623,operating,7646324,2,16-11-2010,23-08-2013,1,1011,14929,15940
3624,closed,310000,1,01-12-2011,01-12-2011,7,0,15309,15309
3625,operating,10000000,1,16-06-2011,16-06-2011,1,0,15141,15141
3626,operating,,1,01-11-2007,01-11-2007,1,0,13818,13818
3627,operating,,1,20-09-2013,20-09-2013,4,0,15968,15968
3628,operating,40000,1,23-08-2011,23-08-2011,1,0,15209,15209
3629,operating,,1,12-12-2014,12-12-2014,1,0,16416,16416
3630,operating,1600000,1,24-11-2012,24-11-2012,2,0,15668,15668
3631,operating,40000,1,22-08-2013,22-08-2013,1,0,15939,15939
3632,closed,53000000,1,23-10-2000,23-10-2000,6,0,11253,11253
3633,acquired,1800000,1,01-06-2013,01-06-2013,2,0,15857,15857
3634,operating,5999999,1,01-09-2012,01-09-2012,1,0,15584,15584
3635,operating,50000,1,30-10-2013,30-10-2013,1,0,16008,16008
3636,closed,9707638,1,10-03-2015,10-03-2015,1,0,16504,16504
3637,acquired,12123837,4,01-05-2011,05-04-2012,17,340,15095,15435
3638,operating,8665093,3,26-07-2011,19-12-2013,1,877,15181,16058
3639,operating,140000,2,07-03-2015,01-09-2015,2,178,16501,16679
3640,operating,1098400,3,01-12-2012,01-07-2014,9,577,15675,16252
3641,closed,3362500,3,19-03-2009,23-11-2010,3,614,14322,14936
3642,acquired,35000000,1,08-03-2010,08-03-2010,1,0,14676,14676
3643,ipo,12000000,1,27-06-2003,27-06-2003,3,0,12230,12230
3644,operating,,1,22-12-2000,22-12-2000,2,0,11313,11313
3645,operating,,1,04-10-2012,04-10-2012,1,0,15617,15617
3646,acquired,18500000,1,23-01-2008,23-01-2008,1,0,13901,13901
3647,operating,250000,1,15-12-2009,15-12-2009,1,0,14593,14593
3648,closed,374000000,4,08-08-2005,21-03-2007,28,590,13003,13593
3649,operating,,1,09-04-2014,09-04-2014,7,0,16169,16169
3650,operating,20106,1,01-08-2014,01-08-2014,1,0,16283,16283
3651,operating,,1,01-05-2011,01-05-2011,1,0,15095,15095
3652,acquired,5000000,1,01-06-2006,01-06-2006,1,0,13300,13300
3653,operating,1200000,1,17-07-2015,17-07-2015,5,0,16633,16633
3654,operating,2000000,1,15-10-2015,15-10-2015,2,0,16723,16723
3655,operating,,2,31-07-2013,03-02-2014,2,187,15917,16104
3656,operating,20000,1,01-09-2013,01-09-2013,1,0,15949,15949
3657,operating,,1,16-02-2015,16-02-2015,1,0,16482,16482
3658,operating,1330000,3,10-10-2011,13-04-2014,2,916,15257,16173
3659,operating,850000,1,30-01-2014,30-01-2014,2,0,16100,16100
3660,operating,410000,2,22-08-2013,15-02-2015,1,542,15939,16481
3661,operating,50000,1,01-10-2014,01-10-2014,1,0,16344,16344
3662,operating,39900,2,01-01-2001,20-12-2010,1,3640,11323,14963
3663,operating,,1,01-04-2010,01-04-2010,1,0,14700,14700
3664,operating,34000000,5,14-08-2012,22-07-2015,4,1072,15566,16638
3665,operating,1190000,1,06-09-2006,06-09-2006,1,0,13397,13397
3666,operating,1908820,2,01-04-2011,31-01-2013,2,671,15065,15736
3667,operating,2700000,1,30-01-2010,30-01-2010,2,0,14639,14639
3668,operating,45000000,3,01-01-2012,01-01-2013,2,366,15340,15706
3669,operating,16000000,3,05-02-2010,18-11-2014,8,1747,14645,16392
3670,acquired,97800000,5,30-06-2005,22-04-2009,27,1392,12964,14356
3671,operating,2550000,3,20-01-2013,10-08-2015,3,932,15725,16657
3672,operating,2000000,1,19-08-2014,19-08-2014,2,0,16301,16301
3673,operating,,1,10-06-2014,10-06-2014,1,0,16231,16231
3674,operating,7000000,2,15-09-2011,24-07-2012,6,313,15232,15545
3675,acquired,500000,1,05-11-2013,05-11-2013,4,0,16014,16014
3676,operating,40000,1,30-11-2011,30-11-2011,1,0,15308,15308
3677,operating,2030939,3,25-09-2010,26-03-2015,4,1643,14877,16520
3678,acquired,83574271,5,12-08-2005,14-12-2012,5,2681,13007,15688
3679,operating,19026410,2,05-08-2008,01-11-2010,1,818,14096,14914
3680,acquired,27500000,7,01-09-2006,08-04-2014,9,2776,13392,16168
3681,operating,47150000,3,01-09-2010,16-03-2015,19,1657,14853,16510
3682,operating,,1,29-01-2009,29-01-2009,1,0,14273,14273
3683,operating,7753929,2,10-08-2010,01-12-2010,3,113,14831,14944
3684,operating,1546558,1,21-06-2012,21-06-2012,2,0,15512,15512
3685,operating,6200000,3,23-07-2010,04-02-2015,2,1657,14813,16470
3686,operating,70000,1,01-03-2011,01-03-2011,3,0,15034,15034
3687,operating,,1,04-03-2014,04-03-2014,1,0,16133,16133
3688,operating,100000,1,01-07-2012,01-07-2012,1,0,15522,15522
3689,operating,8900000,5,23-11-2010,16-12-2014,8,1484,14936,16420
3690,operating,4125000,6,01-11-2012,25-03-2014,22,509,15645,16154
3691,operating,3000000,1,07-07-2015,07-07-2015,2,0,16623,16623
3692,closed,14000000,1,11-06-2001,11-06-2001,5,0,11484,11484
3693,operating,,1,01-01-2013,01-01-2013,1,0,15706,15706
3694,operating,216977,2,01-09-2013,01-10-2014,6,395,15949,16344
3695,closed,3700000,2,10-09-2012,26-09-2013,7,381,15593,15974
3696,operating,340000,2,12-12-2012,15-01-2014,2,399,15686,16085
3697,operating,,2,20-08-2014,06-07-2015,2,320,16302,16622
3698,operating,1000000,1,04-03-2015,04-03-2015,1,0,16498,16498
3699,operating,750000,1,30-09-2012,30-09-2012,5,0,15613,15613
3700,closed,200000,1,01-06-2012,01-06-2012,1,0,15492,15492
3701,operating,,1,03-04-2009,03-04-2009,1,0,14337,14337
3702,operating,,1,30-09-2013,30-09-2013,1,0,15978,15978
3703,operating,,1,10-08-2011,10-08-2011,1,0,15196,15196
3704,operating,100000,1,23-04-2015,23-04-2015,1,0,16548,16548
3705,operating,40000,1,05-04-2012,05-04-2012,1,0,15435,15435
3706,operating,40000,1,09-08-2012,09-08-2012,1,0,15561,15561
3707,operating,118188900,9,01-09-2006,31-12-2014,31,3043,13392,16435
3708,operating,165000,2,08-06-2015,15-07-2015,1,37,16594,16631
3709,operating,1275000,2,07-01-2013,02-12-2015,3,1059,15712,16771
3710,operating,2513724,3,23-06-2014,06-04-2015,1,287,16244,16531
3711,operating,1500000,1,19-02-2015,19-02-2015,2,0,16485,16485
3712,operating,6000000,1,16-05-2005,16-05-2005,2,0,12919,12919
3713,operating,25000000,1,25-10-2015,25-10-2015,1,0,16733,16733
3714,operating,275000000,2,01-01-2010,15-04-2014,1,1565,14610,16175
3715,operating,187967,1,01-01-2014,01-01-2014,1,0,16071,16071
3716,operating,2500000,1,01-09-2007,01-09-2007,1,0,13757,13757
3717,operating,1150000,2,26-06-2015,23-10-2015,1,119,16612,16731
3718,operating,9717821,2,01-04-2006,29-06-2015,4,3376,13239,16615
3719,operating,,1,18-08-2009,18-08-2009,1,0,14474,14474
3720,operating,18826300,2,18-09-2008,25-06-2013,2,1741,14140,15881
3721,operating,22000000,2,12-11-2014,02-06-2015,5,202,16386,16588
3722,acquired,10000000,1,28-06-2001,28-06-2001,3,0,11501,11501
3723,operating,,1,15-01-2015,15-01-2015,1,0,16450,16450
3724,closed,21688477,6,03-02-2009,16-02-2014,10,1839,14278,16117
3725,operating,600000,1,24-10-2015,24-10-2015,2,0,16732,16732
3726,operating,1070000000,4,01-08-2010,19-01-2015,9,1632,14822,16454
3727,operating,67478,1,01-10-2011,01-10-2011,1,0,15248,15248
3728,operating,25000000,1,27-06-2014,27-06-2014,1,0,16248,16248
3729,operating,260000000,1,01-06-2008,01-06-2008,3,0,14031,14031
3730,operating,114644,1,01-07-2013,01-07-2013,2,0,15887,15887
3731,acquired,21000000,2,03-09-2008,26-01-2009,5,145,14125,14270
3732,operating,1580000,1,22-02-2013,22-02-2013,1,0,15758,15758
3733,operating,1250000,1,01-06-2013,01-06-2013,1,0,15857,15857
3734,operating,6000000,2,01-06-2004,01-12-2006,1,913,12570,13483
3735,operating,142627,2,01-05-2013,01-08-2013,2,92,15826,15918
3736,operating,653717,1,01-03-2013,01-03-2013,1,0,15765,15765
3737,operating,10563501,3,01-07-2009,19-09-2012,10,1176,14426,15602
3738,operating,2550000,2,01-01-2008,01-01-2009,1,366,13879,14245
3739,operating,28000,1,01-07-2012,01-07-2012,1,0,15522,15522
3740,closed,4158499,2,21-01-2009,11-01-2011,2,720,14265,14985
3741,operating,14771601,2,01-12-2007,29-05-2015,3,2736,13848,16584
3742,operating,44000000,2,07-12-2009,14-02-2012,6,799,14585,15384
3743,operating,2000000,1,01-02-2010,01-02-2010,1,0,14641,14641
3744,operating,2000000,1,20-05-2014,20-05-2014,2,0,16210,16210
3745,ipo,13000000,1,16-02-2004,16-02-2004,5,0,12464,12464
3746,closed,32000000,1,07-01-2004,07-01-2004,2,0,12424,12424
3747,operating,38924,1,01-01-2015,01-01-2015,1,0,16436,16436
3748,closed,1090000,1,13-01-2009,13-01-2009,2,0,14257,14257
3749,operating,80000000,1,06-10-2005,06-10-2005,1,0,13062,13062
3750,operating,40000,1,21-07-2011,21-07-2011,1,0,15176,15176
3751,operating,850000,2,03-11-2011,03-01-2013,4,427,15281,15708
3752,acquired,39422003,3,07-05-2008,19-02-2012,3,1383,14006,15389
3753,operating,336269,6,14-09-2011,10-02-2015,3,1245,15231,16476
3754,operating,1600000,1,13-08-2013,13-08-2013,2,0,15930,15930
3755,operating,2000000,1,21-07-2015,21-07-2015,6,0,16637,16637
3756,operating,286241,3,11-04-2013,04-08-2014,3,480,15806,16286
3757,closed,58000000,2,19-05-2006,06-03-2007,4,291,13287,13578
3758,operating,6000000,1,01-11-2011,01-11-2011,2,0,15279,15279
3759,operating,26224193,4,01-07-2012,07-10-2015,21,1193,15522,16715
3760,operating,20000,1,01-03-2014,01-03-2014,1,0,16130,16130
3761,operating,1171303,1,01-06-2010,01-06-2010,1,0,14761,14761
3762,operating,22100000,1,12-11-2014,12-11-2014,1,0,16386,16386
3763,operating,750000,1,01-07-2015,01-07-2015,1,0,16617,16617
3764,operating,,1,01-05-2012,01-05-2012,1,0,15461,15461
3765,operating,20000000,1,14-01-2014,14-01-2014,1,0,16084,16084
3766,operating,30750000,4,02-06-2009,13-01-2014,13,1686,14397,16083
3767,operating,3000000,1,04-05-2008,04-05-2008,2,0,14003,14003
3768,operating,,1,01-09-2008,01-09-2008,1,0,14123,14123
3769,operating,10000000,3,23-07-2012,15-07-2015,20,1087,15544,16631
3770,closed,,1,13-11-2009,13-11-2009,2,0,14561,14561
3771,operating,23195725,3,04-01-2012,18-03-2014,1,804,15343,16147
3772,operating,9500000,1,23-09-2004,23-09-2004,4,0,12684,12684
3773,operating,40000,1,01-01-2013,01-01-2013,1,0,15706,15706
3774,acquired,765000,2,01-07-2008,29-10-2009,6,485,14061,14546
3775,operating,3030000,1,03-04-2006,03-04-2006,1,0,13241,13241
3776,acquired,,1,01-11-1999,01-11-1999,1,0,10896,10896
3777,closed,1024999,1,19-03-2004,19-03-2004,2,0,12496,12496
3778,operating,60000000,1,01-12-2011,01-12-2011,1,0,15309,15309
3779,operating,72000000,4,01-10-2007,08-03-2011,5,1254,13787,15041
3780,closed,,1,01-11-1998,01-11-1998,1,0,10531,10531
3781,operating,100000,1,14-07-2014,14-07-2014,1,0,16265,16265
3782,operating,1000000,2,18-08-2014,19-10-2015,1,427,16300,16727
3783,operating,7413693,3,23-10-2012,27-03-2014,1,520,15636,16156
3784,closed,18000,1,11-09-2009,11-09-2009,1,0,14498,14498
3785,operating,,1,01-05-2005,01-05-2005,7,0,12904,12904
3786,closed,671226,1,07-12-2007,07-12-2007,1,0,13854,13854
3787,operating,500000,1,01-01-2014,01-01-2014,1,0,16071,16071
3788,operating,496971.5958,3,01-10-2014,22-10-2015,2,386,16344,16730
3789,operating,200000,1,27-08-2013,27-08-2013,4,0,15944,15944
3790,operating,69337442,1,01-05-2011,01-05-2011,1,0,15095,15095
3791,operating,700000,2,01-09-2011,01-06-2015,2,1369,15218,16587
3792,operating,1300000,1,29-07-2005,29-07-2005,1,0,12993,12993
3793,acquired,2500000,2,01-01-2010,01-07-2011,3,546,14610,15156
3794,operating,1620000,1,23-07-2014,23-07-2014,1,0,16274,16274
3795,operating,280000,1,08-09-2015,08-09-2015,6,0,16686,16686
3796,operating,1350000,2,20-03-2008,17-09-2009,1,546,13958,14504
3797,operating,,1,10-08-1990,10-08-1990,1,0,7526,7526
3798,operating,2000000,1,01-04-2013,01-04-2013,1,0,15796,15796
3799,operating,6000000,1,14-01-2014,14-01-2014,2,0,16084,16084
3800,acquired,5500000,2,10-08-2013,05-05-2014,2,268,15927,16195
3801,operating,75000000,2,16-03-2004,01-01-2009,13,1752,12493,14245
3802,operating,300000,3,01-04-2013,01-10-2013,4,183,15796,15979
3803,operating,255510,2,30-04-2013,07-09-2014,2,495,15825,16320
3804,operating,3700000,2,02-11-2009,23-05-2012,2,933,14550,15483
3805,acquired,5000000,3,21-10-2010,02-08-2012,5,651,14903,15554
3806,acquired,47799995,4,07-11-2003,30-12-2009,9,2245,12363,14608
3807,operating,4722200,1,01-12-2011,01-12-2011,2,0,15309,15309
3808,operating,138000,4,07-02-2014,15-09-2014,1,220,16108,16328
3809,acquired,,1,01-01-2012,01-01-2012,1,0,15340,15340
3810,operating,850000,2,21-11-2013,01-03-2014,2,100,16030,16130
3811,operating,,1,08-11-2012,08-11-2012,1,0,15652,15652
3812,operating,12800000,3,23-05-2011,01-10-2015,5,1592,15117,16709
3813,operating,5000000,1,05-05-2011,05-05-2011,1,0,15099,15099
3814,operating,40000,1,18-07-2012,18-07-2012,1,0,15539,15539
3815,operating,1168000,6,26-08-2010,13-09-2013,6,1114,14847,15961
3816,operating,4970000,2,01-01-2011,01-02-2012,3,396,14975,15371
3817,operating,255000,1,14-12-2014,14-12-2014,1,0,16418,16418
3818,operating,14000000,2,25-07-2001,05-12-2013,4,4516,11528,16044
3819,closed,100000,1,21-06-2011,21-06-2011,6,0,15146,15146
3820,operating,56474999,6,01-03-2010,16-04-2015,5,1872,14669,16541
3821,operating,5763,1,21-11-2014,21-11-2014,1,0,16395,16395
3822,operating,5000000,1,19-05-2015,19-05-2015,2,0,16574,16574
3823,operating,4015000,3,01-06-2010,17-08-2012,8,808,14761,15569
3824,operating,,1,21-01-2015,21-01-2015,1,0,16456,16456
3825,operating,5400000,1,16-09-2013,16-09-2013,2,0,15964,15964
3826,acquired,13000000,1,07-11-2003,07-11-2003,2,0,12363,12363
3827,closed,20000,1,31-08-2010,31-08-2010,1,0,14852,14852
3828,acquired,52000000,2,06-09-2007,26-03-2009,6,567,13762,14329
3829,operating,,1,01-11-2010,01-11-2010,1,0,14914,14914
3830,operating,350000,1,01-08-2010,01-08-2010,2,0,14822,14822
3831,operating,235000,1,01-03-2013,01-03-2013,1,0,15765,15765
3832,operating,12500,2,29-04-2014,10-11-2014,2,195,16189,16384
3833,acquired,,1,12-03-2009,12-03-2009,1,0,14315,14315
3834,operating,7000000,3,27-08-2012,09-11-2015,7,1169,15579,16748
3835,operating,15000000,1,11-08-2000,11-08-2000,4,0,11180,11180
3836,operating,378812,1,08-12-2013,08-12-2013,1,0,16047,16047
3837,operating,17330000,3,23-03-2006,27-05-2010,10,1526,13230,14756
3838,operating,13100000,3,22-12-2011,13-02-2014,7,784,15330,16114
3839,closed,4000000,1,01-05-2008,01-05-2008,2,0,14000,14000
3840,operating,37647727,2,07-04-2014,18-12-2014,2,255,16167,16422
3841,operating,32000000,3,18-04-2013,19-02-2015,7,672,15813,16485
3842,operating,120000,1,06-07-2015,06-07-2015,1,0,16622,16622
3843,acquired,4156680,2,01-01-2005,24-10-2008,2,1392,12784,14176
3844,acquired,,1,01-06-2011,01-06-2011,1,0,15126,15126
3845,operating,4254942,2,01-01-2011,31-03-2014,2,1185,14975,16160
3846,operating,1511444,1,20-04-2014,20-04-2014,1,0,16180,16180
3847,operating,38964,1,15-07-2015,15-07-2015,1,0,16631,16631
3848,operating,25000,1,01-12-2011,01-12-2011,3,0,15309,15309
3849,operating,20000000,1,19-05-2014,19-05-2014,2,0,16209,16209
3850,operating,707630,2,01-02-2012,17-01-2014,2,716,15371,16087
3851,acquired,64080000,3,01-01-2005,23-03-2009,8,1542,12784,14326
3852,operating,73615481,7,06-02-2002,01-07-2012,18,3798,11724,15522
3853,operating,,1,14-11-2014,14-11-2014,1,0,16388,16388
3854,operating,6300000,2,21-08-2013,05-08-2015,7,714,15938,16652
3855,operating,34600000,4,01-10-2010,29-10-2014,7,1489,14883,16372
3856,operating,8800000,1,13-05-2010,13-05-2010,1,0,14742,14742
3857,operating,100000,1,01-10-2013,01-10-2013,1,0,15979,15979
3858,acquired,28679147,4,01-08-2010,23-01-2014,16,1271,14822,16093
3859,operating,5000000,1,04-10-2013,04-10-2013,1,0,15982,15982
3860,closed,2500000,1,15-07-2009,15-07-2009,1,0,14440,14440
3861,operating,51311845,8,19-09-2005,20-08-2013,27,2892,13045,15937
3862,operating,30000000,2,01-04-2014,19-08-2014,4,140,16161,16301
3863,operating,23522700,3,04-04-2013,14-09-2015,6,893,15799,16692
3864,operating,12200000,1,17-07-2006,17-07-2006,3,0,13346,13346
3865,closed,150000,1,13-05-2011,13-05-2011,1,0,15107,15107
3866,acquired,35000000,5,01-03-2004,07-06-2007,10,1193,12478,13671
3867,operating,565000,1,01-05-2011,01-05-2011,7,0,15095,15095
3868,operating,5000000,1,17-12-2014,17-12-2014,1,0,16421,16421
3869,operating,,2,20-06-2011,20-03-2012,2,274,15145,15419
3870,operating,2000000,1,04-02-2014,04-02-2014,1,0,16105,16105
3871,closed,75000,1,01-05-2015,01-05-2015,1,0,16556,16556
3872,operating,7000000,1,24-01-2001,24-01-2001,1,0,11346,11346
3873,operating,26937803,4,18-04-2011,30-09-2014,5,1261,15082,16343
3874,operating,1885000,2,01-03-2013,01-09-2014,1,549,15765,16314
3875,operating,7500000,4,29-05-2012,11-03-2015,31,1016,15489,16505
3876,operating,,1,13-11-2014,13-11-2014,1,0,16387,16387
3877,operating,1909535,2,16-09-2014,09-09-2015,4,358,16329,16687
3878,operating,1543920,1,21-10-2013,21-10-2013,1,0,15999,15999
3879,operating,55000000,3,21-08-2012,26-10-2015,6,1161,15573,16734
3880,operating,78950000,4,14-01-2014,30-12-2014,29,350,16084,16434
3881,operating,,1,14-02-2012,14-02-2012,1,0,15384,15384
3882,operating,,1,11-07-2007,11-07-2007,1,0,13705,13705
3883,acquired,,1,20-11-2000,20-11-2000,1,0,11281,11281
3884,operating,400000,1,24-09-2015,24-09-2015,5,0,16702,16702
3885,operating,105000000,2,20-10-2014,09-01-2015,1,81,16363,16444
3886,operating,1283027,1,17-10-2014,17-10-2014,1,0,16360,16360
3887,ipo,91100000,2,28-01-2002,18-08-2010,15,3124,11715,14839
3888,operating,78500,2,09-08-2012,18-06-2013,1,313,15561,15874
3889,operating,1227153.503,1,22-12-2014,22-12-2014,4,0,16426,16426
3890,acquired,4200010,2,18-07-2012,05-02-2013,2,202,15539,15741
3891,operating,100000,1,15-09-2014,15-09-2014,1,0,16328,16328
3892,operating,22162918,8,21-02-2008,16-01-2015,25,2521,13930,16451
3893,operating,6500000,1,16-02-2015,16-02-2015,1,0,16482,16482
3894,operating,,1,05-03-2012,05-03-2012,1,0,15404,15404
3895,operating,,1,05-02-2015,05-02-2015,1,0,16471,16471
3896,operating,,1,28-02-2000,28-02-2000,1,0,11015,11015
3897,operating,3047120,2,14-01-2014,02-09-2014,2,231,16084,16315
3898,operating,,1,01-01-2015,01-01-2015,1,0,16436,16436
3899,closed,,1,24-02-2012,24-02-2012,1,0,15394,15394
3900,operating,1350000,5,01-09-2010,31-05-2015,11,1733,14853,16586
3901,operating,1314060,1,01-08-2015,01-08-2015,1,0,16648,16648
3902,operating,405279,1,27-03-2014,27-03-2014,1,0,16156,16156
3903,operating,50000,2,06-11-2012,01-09-2013,1,299,15650,15949
3904,operating,1500000,1,26-05-2011,26-05-2011,1,0,15120,15120
3905,operating,375247,1,15-11-2014,15-11-2014,2,0,16389,16389
3906,operating,,1,01-03-2009,01-03-2009,2,0,14304,14304
3907,operating,,1,13-08-2015,13-08-2015,1,0,16660,16660
3908,acquired,,1,04-04-2009,04-04-2009,1,0,14338,14338
3909,operating,2750000,4,01-04-2011,22-05-2014,2,1147,15065,16212
3910,acquired,1300000,1,17-09-2013,17-09-2013,9,0,15965,15965
3911,operating,179961674,8,11-10-2005,23-12-2013,17,2995,13067,16062
3912,operating,23264207,2,15-07-2014,10-07-2015,42,360,16266,16626
3913,acquired,21000000,4,13-05-2004,01-01-2008,14,1328,12551,13879
3914,operating,1850000,2,23-06-2014,02-02-2015,2,224,16244,16468
3915,acquired,37000000,5,01-05-2005,01-08-2010,10,1918,12904,14822
3916,operating,1750000,2,10-01-2013,26-09-2015,3,989,15715,16704
3917,closed,25000,1,16-08-2012,16-08-2012,1,0,15568,15568
3918,operating,710000,7,16-07-2013,01-04-2015,7,624,15902,16526
3919,operating,32500000,1,19-08-2015,19-08-2015,4,0,16666,16666
3920,acquired,28800000,3,10-10-2008,11-09-2012,6,1432,14162,15594
3921,operating,7000000,2,01-12-2013,16-10-2014,3,319,16040,16359
3922,operating,45200000,3,07-04-2010,04-06-2012,7,789,14706,15495
3923,operating,650000,2,30-09-2014,17-02-2015,1,140,16343,16483
3924,closed,100000,1,01-02-2011,01-02-2011,1,0,15006,15006
3925,operating,1000000,1,05-11-2014,05-11-2014,3,0,16379,16379
3926,closed,1298719.147,1,04-12-2007,04-12-2007,1,0,13851,13851
3927,operating,,1,01-04-2013,01-04-2013,1,0,15796,15796
3928,operating,25000000,2,15-05-2007,30-11-2007,2,199,13648,13847
3929,operating,100000000,1,17-09-2013,17-09-2013,1,0,15965,15965
3930,operating,3473187,1,01-02-2015,01-02-2015,1,0,16467,16467
3931,operating,3000000,1,14-02-2013,14-02-2013,1,0,15750,15750
3932,operating,5596492.443,3,01-06-2013,26-06-2015,2,755,15857,16612
3933,operating,200000,1,18-03-2015,18-03-2015,1,0,16512,16512
3934,operating,20000,1,06-08-2012,06-08-2012,1,0,15558,15558
3935,operating,50000,1,01-03-2015,01-03-2015,1,0,16495,16495
3936,operating,1506705,3,10-04-2013,09-11-2015,4,943,15805,16748
3937,operating,10000000,1,01-04-2011,01-04-2011,1,0,15065,15065
3938,closed,30000,1,10-08-2014,10-08-2014,1,0,16292,16292
3939,operating,58799998,7,22-05-2007,21-10-2014,13,2709,13655,16364
3940,operating,,1,01-01-2013,01-01-2013,1,0,15706,15706
3941,acquired,14500000,2,01-01-2004,01-01-2006,2,731,12418,13149
3942,operating,50000,1,19-08-2013,19-08-2013,1,0,15936,15936
3943,operating,1010000,1,25-03-2010,25-03-2010,3,0,14693,14693
3944,acquired,1000000,1,08-10-2012,08-10-2012,1,0,15621,15621
3945,operating,450000,1,12-03-2014,12-03-2014,1,0,16141,16141
3946,acquired,1820000,3,01-11-2011,07-06-2012,3,219,15279,15498
3947,closed,202250.0316,1,01-11-2015,01-11-2015,1,0,16740,16740
3948,operating,15000,1,01-06-2010,01-06-2010,1,0,14761,14761
3949,operating,280000,2,20-10-2010,01-01-2011,3,73,14902,14975
3950,operating,5500000,1,08-04-2015,08-04-2015,1,0,16533,16533
3951,operating,5000000,1,14-07-2015,14-07-2015,4,0,16630,16630
3952,operating,361000000,3,10-12-2008,04-04-2011,2,845,14223,15068
3953,operating,1238277,2,21-12-2012,23-05-2015,1,883,15695,16578
3954,operating,1300000,1,25-04-2012,25-04-2012,1,0,15455,15455
3955,operating,,1,01-12-2014,01-12-2014,1,0,16405,16405
3956,operating,240000,1,21-11-2014,21-11-2014,1,0,16395,16395
3957,operating,28650000,3,21-05-2007,25-07-2013,5,2257,13654,15911
3958,ipo,,1,30-09-1992,30-09-1992,1,0,8308,8308
3959,operating,,2,01-08-2011,01-02-2013,2,550,15187,15737
3960,operating,1000000,1,22-04-2010,22-04-2010,1,0,14721,14721
3961,operating,1800000,5,07-07-2009,25-07-2013,9,1479,14432,15911
3962,ipo,73300000,6,24-06-2009,10-06-2013,9,1447,14419,15866
3963,operating,7600000,1,06-09-2012,06-09-2012,4,0,15589,15589
3964,closed,6230757,4,15-08-2006,16-12-2009,17,1219,13375,14594
3965,operating,40000,1,21-09-2011,21-09-2011,1,0,15238,15238
3966,operating,25000,1,01-12-2013,01-12-2013,1,0,16040,16040
3967,acquired,3250000,1,04-12-2001,04-12-2001,1,0,11660,11660
3968,operating,4392386,1,01-04-2010,01-04-2010,1,0,14700,14700
3969,operating,141000000,3,28-03-2010,09-04-2014,15,1473,14696,16169
3970,closed,5000000,1,30-10-2007,30-10-2007,1,0,13816,13816
3971,operating,187500,3,30-01-2015,01-06-2015,1,122,16465,16587
3972,acquired,,1,24-01-2012,24-01-2012,1,0,15363,15363
3973,operating,800000,1,01-10-2014,01-10-2014,5,0,16344,16344
3974,operating,,1,03-01-2012,03-01-2012,1,0,15342,15342
3975,operating,1500000,3,01-02-2012,07-05-2013,7,461,15371,15832
3976,operating,6000000,1,20-10-2015,20-10-2015,3,0,16728,16728
3977,operating,600000,2,01-08-2014,12-02-2015,2,195,16283,16478
3978,operating,13424242.2,2,20-12-2005,24-09-2007,4,643,13137,13780
3979,operating,,1,01-01-2013,01-01-2013,1,0,15706,15706
3980,operating,16500000,2,23-10-2006,04-12-2008,3,773,13444,14217
3981,operating,12000000,1,13-03-2013,13-03-2013,1,0,15777,15777
3982,operating,2012004,2,01-03-2009,14-05-2014,2,1900,14304,16204
3983,operating,10900000,2,22-11-2011,01-03-2013,3,465,15300,15765
3984,operating,,2,01-08-2013,18-12-2013,1,139,15918,16057
3985,operating,,1,04-04-2011,04-04-2011,1,0,15068,15068
3986,operating,150000,1,03-11-2015,03-11-2015,2,0,16742,16742
3987,operating,580000,1,10-07-2012,10-07-2012,2,0,15531,15531
3988,operating,62143,1,25-11-2014,25-11-2014,1,0,16399,16399
3989,operating,435000,1,01-12-2014,01-12-2014,7,0,16405,16405
3990,operating,121272.5721,3,01-02-2014,01-05-2015,3,454,16102,16556
3991,operating,,1,20-12-2011,20-12-2011,2,0,15328,15328
3992,operating,12600000,4,08-10-2010,15-03-2012,8,524,14890,15414
3993,operating,36000000,1,04-03-2013,04-03-2013,6,0,15768,15768
3994,operating,1000000,1,11-12-2007,11-12-2007,1,0,13858,13858
3995,operating,,1,20-01-2015,20-01-2015,1,0,16455,16455
3996,closed,18000,1,06-08-2009,06-08-2009,1,0,14462,14462
3997,acquired,14250000,3,22-09-2010,24-10-2014,8,1493,14874,16367
3998,operating,1000000,1,31-03-2013,31-03-2013,1,0,15795,15795
3999,operating,1950000,2,23-04-2007,26-06-2008,1,430,13626,14056
4000,operating,,1,05-10-2015,05-10-2015,1,0,16713,16713
4001,operating,27000000,1,01-11-2010,01-11-2010,1,0,14914,14914
4002,operating,2778844,4,30-05-2013,15-06-2015,4,746,15855,16601
4003,acquired,49000000,5,14-10-2005,09-02-2012,15,2309,13070,15379
4004,operating,3400000,1,24-11-2010,24-11-2010,1,0,14937,14937
4005,operating,,1,31-03-2015,31-03-2015,1,0,16525,16525
4006,operating,2450000,2,24-05-2013,11-02-2014,5,263,15849,16112
4007,operating,,1,01-01-2003,01-01-2003,1,0,12053,12053
4008,operating,5000000,1,25-10-2002,25-10-2002,1,0,11985,11985
4009,operating,2250000,1,27-03-2015,27-03-2015,13,0,16521,16521
4010,operating,1000000,1,26-03-2014,26-03-2014,6,0,16155,16155
4011,operating,190000,3,01-05-2011,18-03-2013,5,687,15095,15782
4012,operating,5100000,1,13-08-2010,13-08-2010,2,0,14834,14834
4013,operating,350000,1,01-06-2013,01-06-2013,4,0,15857,15857
4014,operating,,1,01-06-2013,01-06-2013,1,0,15857,15857
4015,ipo,106550010,4,10-08-2005,18-06-2012,24,2504,13005,15509
4016,acquired,10000000,1,19-05-2004,19-05-2004,1,0,12557,12557
4017,operating,25541542,5,30-11-2012,29-05-2015,3,910,15674,16584
4018,acquired,55800000,2,12-12-2003,01-12-2006,21,1085,12398,13483
4019,closed,16000000,1,11-12-2001,11-12-2001,4,0,11667,11667
4020,operating,500000,1,01-06-2012,01-06-2012,2,0,15492,15492
4021,closed,,1,01-08-2014,01-08-2014,1,0,16283,16283
4022,operating,4275852,2,17-06-2011,07-09-2012,3,448,15142,15590
4023,operating,,1,01-07-2004,01-07-2004,1,0,12600,12600
4024,operating,5000000,1,06-06-2007,06-06-2007,1,0,13670,13670
4025,operating,,1,23-06-2014,23-06-2014,1,0,16244,16244
4026,operating,2196193,3,01-10-2008,01-07-2011,3,1003,14153,15156
4027,operating,20500000,1,27-02-2006,27-02-2006,4,0,13206,13206
4028,operating,82000000,2,28-01-2014,28-09-2015,22,608,16098,16706
4029,operating,300000,1,01-01-2014,01-01-2014,1,0,16071,16071
4030,operating,24700000,3,19-03-2012,28-09-2015,6,1288,15418,16706
4031,operating,112533998,4,15-03-2010,07-08-2015,25,1971,14683,16654
4032,operating,,1,01-01-2013,01-01-2013,1,0,15706,15706
4033,operating,78500000,4,01-01-2012,08-10-2014,7,1011,15340,16351
4034,operating,21015000,4,01-05-2008,29-07-2015,7,2645,14000,16645
4035,operating,110635271,3,25-08-2008,08-09-2015,13,2570,14116,16686
4036,operating,120000,1,01-12-2014,01-12-2014,3,0,16405,16405
4037,operating,29600000,2,12-11-2013,19-10-2015,5,706,16021,16727
4038,acquired,97200000,5,05-03-2007,30-06-2010,18,1213,13577,14790
4039,operating,67000,1,22-02-2010,22-02-2010,1,0,14662,14662
4040,operating,591346,1,13-06-2014,13-06-2014,1,0,16234,16234
4041,operating,44707328,4,30-06-2008,10-07-2012,14,1471,14060,15531
4042,operating,3378281,2,01-03-2008,03-09-2015,1,2742,13939,16681
4043,operating,300000,1,31-08-2015,31-08-2015,2,0,16678,16678
4044,ipo,86526744,11,27-01-2005,14-07-2015,21,3820,12810,16630
4045,operating,5000000,1,11-02-2008,11-02-2008,2,0,13920,13920
4046,operating,17000000,2,23-10-2014,24-10-2014,1,1,16366,16367
4047,operating,130213,3,05-01-2012,10-08-2012,3,218,15344,15562
4048,operating,,1,15-03-2014,15-03-2014,2,0,16144,16144
4049,operating,1200000,1,03-08-2015,03-08-2015,2,0,16650,16650
4050,operating,10000000,2,27-06-2007,01-08-2010,3,1131,13691,14822
4051,operating,,1,01-09-2012,01-09-2012,3,0,15584,15584
4052,operating,,2,21-02-2014,30-04-2015,4,433,16122,16555
4053,operating,100000,1,01-01-2009,01-01-2009,1,0,14245,14245
4054,operating,7755000,4,12-04-2011,10-04-2014,9,1094,15076,16170
4055,operating,874789,1,06-11-2014,06-11-2014,1,0,16380,16380
4056,closed,1094162,7,01-01-2009,01-01-2012,9,1095,14245,15340
4057,operating,,1,01-08-2014,01-08-2014,1,0,16283,16283
4058,operating,,1,11-08-2014,11-08-2014,1,0,16293,16293
4059,operating,13966279,3,01-11-2012,13-10-2015,8,1076,15645,16721
4060,operating,,1,01-02-2015,01-02-2015,2,0,16467,16467
4061,operating,120000,1,21-12-2014,21-12-2014,1,0,16425,16425
4062,operating,2400000,3,29-01-2014,10-12-2014,4,315,16099,16414
4063,operating,,1,23-06-2015,23-06-2015,1,0,16609,16609
4064,acquired,34000000,1,01-01-2007,01-01-2007,4,0,13514,13514
4065,operating,40000,1,06-01-2014,06-01-2014,1,0,16076,16076
4066,acquired,10000000,1,01-01-2006,01-01-2006,1,0,13149,13149
4067,operating,21507228,5,02-03-2010,13-07-2012,1,864,14670,15534
4068,operating,770850,1,21-01-2015,21-01-2015,2,0,16456,16456
4069,operating,10250000,4,01-01-2013,10-09-2015,2,982,15706,16688
4070,operating,1000000,1,17-08-2015,17-08-2015,3,0,16664,16664
4071,operating,41250,1,01-08-2015,01-08-2015,1,0,16648,16648
4072,operating,30000,1,18-03-2014,18-03-2014,1,0,16147,16147
4073,operating,2475000,2,01-11-2013,05-11-2013,4,4,16010,16014
4074,acquired,12000000,1,19-09-2001,19-09-2001,3,0,11584,11584
4075,operating,4566668,4,25-01-2013,21-05-2015,1,846,15730,16576
4076,acquired,13200000,1,09-07-2003,09-07-2003,2,0,12242,12242
4077,operating,38979,1,11-12-2012,11-12-2012,1,0,15685,15685
4078,closed,460000,2,01-10-2009,01-06-2011,2,608,14518,15126
4079,operating,32000000,3,01-05-2012,14-09-2015,8,1231,15461,16692
4080,operating,1030394,4,01-09-2011,10-05-2014,5,982,15218,16200
4081,closed,89881830,3,01-10-2013,23-12-2014,7,448,15979,16427
4082,operating,750000,3,24-09-2012,23-10-2013,7,394,15607,16001
4083,operating,,1,01-12-2011,01-12-2011,1,0,15309,15309
4084,closed,,1,01-06-2015,01-06-2015,1,0,16587,16587
4085,acquired,3000000,1,20-07-2009,20-07-2009,3,0,14445,14445
4086,closed,25000000,1,09-03-2011,09-03-2011,5,0,15042,15042
4087,operating,38979,1,11-12-2012,11-12-2012,1,0,15685,15685
4088,closed,,1,30-11-2005,30-11-2005,1,0,13117,13117
4089,closed,20000,1,01-05-2010,01-05-2010,1,0,14730,14730
4090,operating,2200000,1,07-05-2015,07-05-2015,6,0,16562,16562
4091,acquired,800000,1,29-06-2011,29-06-2011,10,0,15154,15154
4092,closed,125000,1,28-02-2014,28-02-2014,2,0,16129,16129
4093,operating,25000,1,01-03-2014,01-03-2014,1,0,16130,16130
4094,operating,150768,1,11-02-2014,11-02-2014,1,0,16112,16112
4095,operating,101337,2,01-10-2014,01-10-2015,2,365,16344,16709
4096,operating,16876,1,27-02-2015,27-02-2015,1,0,16493,16493
4097,operating,36185166,8,28-11-2007,27-01-2015,5,2617,13845,16462
4098,operating,7927687,1,06-04-2012,06-04-2012,1,0,15436,15436
4099,operating,10000000,1,23-06-2015,23-06-2015,1,0,16609,16609
4100,operating,784929,2,01-03-2012,01-08-2012,3,153,15400,15553
4101,operating,300000,1,16-12-2012,16-12-2012,2,0,15690,15690
4102,operating,500000,1,01-10-2013,01-10-2013,1,0,15979,15979
4103,operating,,1,01-08-2008,01-08-2008,2,0,14092,14092
4104,operating,2000000,1,01-11-2013,01-11-2013,1,0,16010,16010
4105,operating,10335613,3,01-08-2011,07-03-2013,1,584,15187,15771
4106,acquired,27739937.01,3,30-11-2005,19-12-2011,8,2210,13117,15327
4107,operating,11374792,3,24-11-2005,22-03-2010,3,1579,13111,14690
4108,operating,9300000,3,18-12-2006,27-12-2011,4,1835,13500,15335
4109,operating,10000000,1,07-02-2006,07-02-2006,3,0,13186,13186
4110,closed,,1,14-03-2013,14-03-2013,2,0,15778,15778
4111,operating,340000,4,29-10-2014,12-06-2015,5,226,16372,16598
4112,operating,46672800,4,01-08-2006,01-02-2012,10,2010,13361,15371
4113,operating,20000000,1,08-01-2015,08-01-2015,1,0,16443,16443
4114,operating,48580,3,01-04-2013,01-01-2015,1,640,15796,16436
4115,operating,66000000,1,09-10-2015,09-10-2015,1,0,16717,16717
4116,operating,50700000,1,05-06-2014,05-06-2014,1,0,16226,16226
4117,closed,3167062,1,01-11-2002,01-11-2002,1,0,11992,11992
4118,operating,1440000,1,21-07-2010,21-07-2010,1,0,14811,14811
4119,operating,250000,1,01-01-2015,01-01-2015,1,0,16436,16436
4120,operating,3550000,3,03-03-2014,09-04-2015,2,402,16132,16534
4121,acquired,22600000,3,23-04-2003,01-03-2006,5,1043,12165,13208
4122,closed,2500000,1,27-06-2001,27-06-2001,1,0,11500,11500
4123,operating,,1,30-04-2014,30-04-2014,1,0,16190,16190
4124,operating,7000000,3,25-01-2012,01-09-2014,17,950,15364,16314
4125,operating,,3,28-11-2011,01-10-2014,6,1038,15306,16344
4126,operating,,2,23-02-2015,01-09-2015,2,190,16489,16679
4127,operating,,3,01-11-2008,01-04-2011,4,881,14184,15065
4128,acquired,23037230,2,12-07-2006,10-09-2009,5,1156,13341,14497
4129,operating,37000000,3,15-07-2008,23-01-2012,10,1287,14075,15362
4130,acquired,1225000,2,03-12-2012,20-03-2013,4,107,15677,15784
4131,closed,2750000,2,29-08-2003,11-02-2004,2,166,12293,12459
4132,operating,1500000,2,02-10-2008,13-01-2011,1,833,14154,14987
4133,acquired,,1,19-11-2007,19-11-2007,1,0,13836,13836
4134,operating,203000000,3,01-01-2007,01-07-2012,3,2008,13514,15522
4135,operating,,1,01-01-1999,01-01-1999,1,0,10592,10592
4136,operating,1200000,1,07-07-2015,07-07-2015,2,0,16623,16623
4137,operating,108912913,2,07-02-2005,19-12-2010,3,2141,12821,14962
4138,operating,19100000,2,10-01-2003,13-05-2005,8,854,12062,12916
4139,operating,647561,3,01-05-2013,10-03-2014,3,313,15826,16139
4140,operating,4500000,2,01-01-1999,01-01-2002,2,1096,10592,11688
4141,closed,977000,1,24-12-2012,24-12-2012,1,0,15698,15698
4142,operating,,1,13-04-2012,13-04-2012,1,0,15443,15443
4143,operating,300000000,1,16-09-2015,16-09-2015,3,0,16694,16694
4144,operating,100000,1,01-08-2011,01-08-2011,3,0,15187,15187
4145,operating,96150000,3,16-11-2012,10-11-2015,1,1089,15660,16749
4146,operating,50000,2,22-10-2014,13-03-2015,1,142,16365,16507
4147,operating,750000,1,02-07-2014,02-07-2014,2,0,16253,16253
4148,operating,2000000,1,01-09-2009,01-09-2009,7,0,14488,14488
4149,acquired,26600000,6,31-10-2012,06-01-2015,6,797,15644,16441
4150,ipo,1912996,4,01-03-2012,01-03-2014,4,730,15400,16130
4151,operating,,2,14-12-2010,12-09-2011,2,272,14957,15229
4152,operating,1775000,3,04-06-2012,29-07-2014,6,785,15495,16280
4153,operating,458933,1,21-12-2011,21-12-2011,1,0,15329,15329
4154,operating,1015912,1,01-06-2009,01-06-2009,1,0,14396,14396
4155,operating,4200000,1,24-03-2010,24-03-2010,2,0,14692,14692
4156,operating,,2,01-03-2013,26-05-2015,2,816,15765,16581
4157,operating,19491529,2,01-11-2009,24-11-2014,3,1849,14549,16398
4158,operating,33887,1,01-02-2015,01-02-2015,1,0,16467,16467
4159,ipo,91149997,5,26-08-2005,04-06-2015,15,3569,13021,16590
4160,operating,40000,1,25-09-2013,25-09-2013,1,0,15973,15973
4161,operating,1516111,3,20-12-2010,06-05-2015,3,1598,14963,16561
4162,acquired,2940000,1,11-06-2008,11-06-2008,1,0,14041,14041
4163,operating,36000000,1,05-08-2015,05-08-2015,4,0,16652,16652
4164,operating,1492760,2,01-04-2014,01-06-2014,3,61,16161,16222
4165,operating,350000,3,01-01-1999,01-01-2007,2,2922,10592,13514
4166,closed,25000,1,01-04-2013,01-04-2013,1,0,15796,15796
4167,operating,704534,3,01-10-2013,30-04-2015,5,576,15979,16555
4168,operating,1002784331,6,30-01-2012,25-06-2015,9,1242,15369,16611
4169,operating,,2,13-10-2009,21-01-2015,3,1926,14530,16456
4170,operating,103000000,2,14-02-2013,23-04-2015,9,798,15750,16548
4171,operating,2100000,3,09-02-2010,01-07-2013,2,1238,14649,15887
4172,operating,97000,2,01-01-2013,01-03-2013,6,59,15706,15765
4173,ipo,93000000,7,18-08-2004,28-11-2011,23,2658,12648,15306
4174,operating,2000000,1,27-01-2014,27-01-2014,1,0,16097,16097
4175,acquired,10250000,1,17-03-2005,17-03-2005,4,0,12859,12859
4176,operating,2900000,3,01-01-2011,08-04-2014,1,1193,14975,16168
4177,closed,200000,1,05-05-2015,05-05-2015,1,0,16560,16560
4178,closed,18000000,1,24-07-2006,24-07-2006,7,0,13353,13353
4179,operating,10000000,1,11-09-2014,11-09-2014,2,0,16324,16324
4180,operating,2721000,4,01-09-2012,01-04-2014,10,577,15584,16161
4181,acquired,9250000,1,10-02-2005,10-02-2005,3,0,12824,12824
4182,operating,,1,01-03-2013,01-03-2013,1,0,15765,15765
4183,operating,,1,13-11-2014,13-11-2014,1,0,16387,16387
4184,closed,,1,01-01-2012,01-01-2012,1,0,15340,15340
4185,closed,1300000,1,03-04-2013,03-04-2013,9,0,15798,15798
4186,operating,1500000,1,02-11-2015,02-11-2015,1,0,16741,16741
4187,operating,50000,1,01-04-2011,01-04-2011,1,0,15065,15065
4188,acquired,70000000,2,19-09-2012,02-05-2013,2,225,15602,15827
4189,operating,6835529.564,1,14-10-2015,14-10-2015,3,0,16722,16722
4190,operating,7500000,1,08-12-2004,08-12-2004,2,0,12760,12760
4191,operating,15000000,1,05-10-2015,05-10-2015,1,0,16713,16713
4192,operating,15000000,2,09-11-2010,06-07-2011,3,239,14922,15161
4193,operating,36000000,3,01-02-2010,10-09-2014,7,1682,14641,16323
4194,operating,,1,27-08-2012,27-08-2012,1,0,15579,15579
4195,operating,90000000,2,13-01-2014,29-01-2015,2,381,16083,16464
4196,operating,3000000,1,10-06-2014,10-06-2014,1,0,16231,16231
4197,ipo,22300000,3,09-11-2006,23-05-2010,12,1291,13461,14752
4198,operating,,1,12-07-2013,12-07-2013,1,0,15898,15898
4199,operating,1000000,1,19-05-2015,19-05-2015,1,0,16574,16574
4200,operating,,1,01-04-2015,01-04-2015,1,0,16526,16526
4201,operating,65000000,2,31-10-2012,24-02-2014,9,481,15644,16125
4202,acquired,,1,28-06-2010,28-06-2010,2,0,14788,14788
4203,ipo,49024004,3,11-07-2011,05-11-2014,1,1213,15166,16379
4204,operating,28737450,2,05-03-2014,03-12-2014,7,273,16134,16407
4205,operating,2200000,1,14-10-2015,14-10-2015,5,0,16722,16722
4206,closed,1700000,1,06-11-2008,06-11-2008,1,0,14189,14189
4207,operating,5022837,4,01-07-2011,15-06-2015,5,1445,15156,16601
4208,acquired,16800000,2,10-12-2001,01-07-2003,6,568,11666,12234
4209,operating,,1,01-12-2011,01-12-2011,1,0,15309,15309
4210,operating,3500000,1,01-03-2005,01-03-2005,2,0,12843,12843
4211,operating,,1,01-12-2008,01-12-2008,1,0,14214,14214
4212,operating,54725551,1,25-03-2015,25-03-2015,3,0,16519,16519
4213,operating,,1,28-06-2014,28-06-2014,3,0,16249,16249
4214,operating,500000,1,30-07-2001,30-07-2001,7,0,11533,11533
4215,operating,7000000,1,07-12-2011,07-12-2011,1,0,15315,15315
4216,operating,9300000,3,01-03-2004,01-12-2007,6,1370,12478,13848
4217,operating,2100000,1,02-09-2014,02-09-2014,3,0,16315,16315
4218,operating,9100000,4,26-07-2013,10-09-2015,9,776,15912,16688
4219,operating,120000000,5,03-04-2009,18-05-2015,4,2236,14337,16573
4220,closed,1000000,2,01-03-2012,01-08-2012,6,153,15400,15553
4221,operating,3032235,2,24-12-2010,02-04-2013,3,830,14967,15797
4222,operating,12000000,2,01-01-2011,01-03-2014,3,1155,14975,16130
4223,operating,19218000,4,01-07-2011,13-08-2015,23,1504,15156,16660
4224,operating,,1,03-04-2014,03-04-2014,1,0,16163,16163
4225,operating,19615,1,26-02-2013,26-02-2013,1,0,15762,15762
4226,operating,43999999,5,25-08-2008,15-11-2012,8,1543,14116,15659
4227,operating,15000,1,01-03-2013,01-03-2013,1,0,15765,15765
4228,operating,5902201,3,25-10-2006,08-04-2014,10,2722,13446,16168
4229,operating,650000,1,13-05-2013,13-05-2013,6,0,15838,15838
4230,operating,,1,06-08-2014,06-08-2014,2,0,16288,16288
4231,operating,12000000,1,14-09-2010,14-09-2010,1,0,14866,14866
4232,operating,1500000,1,22-10-2010,22-10-2010,1,0,14904,14904
4233,closed,13708150,3,20-08-2007,01-03-2010,5,924,13745,14669
4234,operating,8215242,2,25-06-2014,28-07-2015,3,398,16246,16644
4235,operating,32165,1,16-12-2013,16-12-2013,2,0,16055,16055
4236,operating,19579019,1,15-08-2011,15-08-2011,1,0,15201,15201
4237,operating,40000,1,01-06-2014,01-06-2014,1,0,16222,16222
4238,operating,28000000,1,12-06-2000,12-06-2000,4,0,11120,11120
4239,operating,3001390,4,01-07-2010,15-07-2014,4,1475,14791,16266
4240,operating,3400000,2,01-01-2012,23-08-2015,1,1330,15340,16670
4241,operating,1235000,2,01-12-2012,06-08-2014,7,613,15675,16288
4242,operating,282074000,6,01-01-2005,14-03-2014,10,3359,12784,16143
4243,operating,,1,01-02-2008,01-02-2008,1,0,13910,13910
4244,operating,750000,1,24-05-2012,24-05-2012,7,0,15484,15484
4245,operating,2546269,2,14-11-2013,01-01-2014,6,48,16023,16071
4246,operating,15000000,1,08-08-2008,08-08-2008,3,0,14099,14099
4247,operating,10000,1,01-06-2012,01-06-2012,1,0,15492,15492
4248,closed,,1,28-04-2014,28-04-2014,1,0,16188,16188
4249,operating,,1,02-02-2012,02-02-2012,1,0,15372,15372
4250,operating,8300000,4,25-11-2013,02-10-2015,9,676,16034,16710
4251,operating,1684565,1,27-05-2014,27-05-2014,1,0,16217,16217
4252,operating,23572551,1,01-06-2012,01-06-2012,2,0,15492,15492
4253,operating,,1,01-02-2014,01-02-2014,1,0,16102,16102
4254,operating,,1,01-05-2001,01-05-2001,1,0,11443,11443
4255,operating,18850000,3,27-08-2013,09-09-2015,7,743,15944,16687
4256,operating,430000,2,14-10-2011,30-04-2012,2,199,15261,15460
4257,operating,3787576,12,01-08-2011,15-07-2015,3,1444,15187,16631
4258,operating,750000,1,01-05-2014,01-05-2014,1,0,16191,16191
4259,operating,,1,01-01-2013,01-01-2013,1,0,15706,15706
4260,closed,500000,1,01-07-2008,01-07-2008,1,0,14061,14061
4261,operating,574092,1,29-07-2013,29-07-2013,1,0,15915,15915
4262,operating,500000,1,11-08-2014,11-08-2014,1,0,16293,16293
4263,operating,37079200,2,21-01-2008,27-01-2010,6,737,13899,14636
4264,operating,6200000,1,27-07-2011,27-07-2011,2,0,15182,15182
4265,operating,120000000,1,08-10-2014,08-10-2014,1,0,16351,16351
4266,closed,,1,30-06-2011,30-06-2011,1,0,15155,15155
4267,operating,10000000,3,01-01-2011,31-07-2014,4,1307,14975,16282
4268,operating,6411000,3,30-09-2009,27-09-2012,3,1093,14517,15610
4269,operating,1200000,2,03-02-2014,24-02-2015,5,386,16104,16490
4270,acquired,3500000,2,01-03-2008,01-07-2009,2,487,13939,14426
4271,operating,10000000,1,01-01-2005,01-01-2005,1,0,12784,12784
4272,acquired,2000000,1,05-12-2006,05-12-2006,3,0,13487,13487
4273,operating,550000,2,21-03-2012,01-01-2014,4,651,15420,16071
4274,operating,51489170,7,13-12-2010,07-10-2015,15,1759,14956,16715
4275,operating,1110000,1,01-04-2006,01-04-2006,1,0,13239,13239
4276,operating,6500000,2,31-01-2008,18-04-2011,2,1173,13909,15082
4277,operating,3930701,1,16-03-2006,16-03-2006,2,0,13223,13223
4278,acquired,7500000,1,25-09-2008,25-09-2008,2,0,14147,14147
4279,operating,679638,1,07-07-2014,07-07-2014,8,0,16258,16258
4280,closed,95000,1,13-04-2015,13-04-2015,1,0,16538,16538
4281,operating,1000000,1,11-02-2013,11-02-2013,2,0,15747,15747
4282,operating,,1,01-01-2013,01-01-2013,2,0,15706,15706
4283,acquired,5714285.714,1,14-07-2007,14-07-2007,2,0,13708,13708
4284,operating,,1,08-07-2011,08-07-2011,1,0,15163,15163
4285,operating,85100000,6,01-01-2005,10-07-2014,21,3477,12784,16261
4286,operating,,1,08-02-2011,08-02-2011,1,0,15013,15013
4287,closed,21000000,2,25-04-2006,01-04-2007,10,341,13263,13604
4288,operating,,1,24-12-2013,24-12-2013,1,0,16063,16063
4289,closed,120000,1,20-09-2007,20-09-2007,1,0,13776,13776
4290,closed,6760000,2,07-07-2006,27-01-2010,3,1300,13336,14636
4291,operating,689908,1,21-03-2014,21-03-2014,1,0,16150,16150
4292,operating,13010774,1,15-09-2014,15-09-2014,1,0,16328,16328
4293,operating,25900000,4,13-07-2005,26-03-2010,12,1717,12977,14694
4294,acquired,8000000,2,29-10-2008,01-01-2012,2,1159,14181,15340
4295,closed,,1,01-07-2011,01-07-2011,1,0,15156,15156
4296,operating,25000,1,01-03-2014,01-03-2014,1,0,16130,16130
4297,operating,32407045,1,22-12-2010,22-12-2010,1,0,14965,14965
4298,operating,19275000,1,14-09-2010,14-09-2010,1,0,14866,14866
4299,closed,120000,1,01-09-2013,01-09-2013,2,0,15949,15949
4300,operating,3000000,1,30-06-2003,30-06-2003,4,0,12233,12233
4301,closed,1012227.258,2,01-11-2013,01-10-2014,2,334,16010,16344
4302,operating,4000000,2,10-05-2012,09-06-2014,5,760,15470,16230
4303,operating,13800000,3,05-04-2004,27-01-2010,5,2123,12513,14636
4304,acquired,,1,01-06-2012,01-06-2012,9,0,15492,15492
4305,operating,4200000,2,29-05-2013,17-02-2014,27,264,15854,16118
4306,operating,4625250,3,26-04-2012,17-02-2014,4,662,15456,16118
4307,operating,3520000,2,16-07-2014,29-07-2015,3,378,16267,16645
4308,operating,1750000,1,17-07-2015,17-07-2015,1,0,16633,16633
4309,operating,41250,1,01-12-2014,01-12-2014,1,0,16405,16405
4310,operating,140000,1,01-03-2014,01-03-2014,2,0,16130,16130
4311,operating,12853500,8,12-01-2012,18-11-2014,2,1041,15351,16392
4312,operating,1150000,1,18-05-2005,18-05-2005,3,0,12921,12921
4313,operating,70000,1,01-11-2013,01-11-2013,1,0,16010,16010
4314,operating,520000,1,08-06-2014,08-06-2014,4,0,16229,16229
4315,operating,500002,3,04-02-2012,02-05-2015,1,1183,15374,16557
4316,operating,,1,01-03-2012,01-03-2012,1,0,15400,15400
4317,operating,3000000,1,24-05-2006,24-05-2006,1,0,13292,13292
4318,operating,28753,1,14-06-2013,14-06-2013,2,0,15870,15870
4319,operating,1600000,1,10-01-2011,10-01-2011,1,0,14984,14984
4320,acquired,22400000,1,04-12-2002,04-12-2002,8,0,12025,12025
4321,operating,200000,1,01-01-2015,01-01-2015,1,0,16436,16436
4322,operating,6300000,2,08-06-2007,19-03-2008,2,285,13672,13957
4323,operating,25000,1,14-03-2013,14-03-2013,1,0,15778,15778
4324,operating,2700000,3,01-10-2013,28-07-2015,1,665,15979,16644
4325,acquired,20000000,1,27-10-2005,27-10-2005,2,0,13083,13083
4326,acquired,16000000,1,17-07-2007,17-07-2007,3,0,13711,13711
4327,operating,1050000,1,24-01-2013,24-01-2013,1,0,15729,15729
4328,operating,,1,02-08-2011,02-08-2011,1,0,15188,15188
4329,operating,,1,21-10-2013,21-10-2013,2,0,15999,15999
4330,operating,219358,1,01-01-2014,01-01-2014,1,0,16071,16071
4331,operating,3200000,4,01-03-2008,01-07-2013,7,1948,13939,15887
4332,closed,18000,1,01-05-2013,01-05-2013,1,0,15826,15826
4333,acquired,31000000,1,14-07-2015,14-07-2015,1,0,16630,16630
4334,operating,133000000,2,26-10-2007,18-07-2014,4,2457,13812,16269
4335,operating,,1,10-03-2015,10-03-2015,1,0,16504,16504
4336,operating,,1,10-08-2014,10-08-2014,2,0,16292,16292
4337,operating,260835,3,01-12-2012,02-02-2014,5,428,15675,16103
4338,operating,416477.7633,3,23-04-2014,04-11-2015,2,560,16183,16743
4339,acquired,158500000,2,17-06-2008,18-05-2011,8,1065,14047,15112
4340,acquired,16000000,1,06-01-2003,06-01-2003,9,0,12058,12058
4341,operating,15000000,1,24-03-2014,24-03-2014,2,0,16153,16153
4342,closed,500000,1,01-08-2010,01-08-2010,1,0,14822,14822
4343,operating,12600000,2,30-11-2013,08-08-2015,16,616,16039,16655
4344,operating,,1,01-01-2014,01-01-2014,1,0,16071,16071
4345,operating,,1,01-02-2014,01-02-2014,1,0,16102,16102
4346,operating,700000,3,01-02-2013,17-09-2013,5,228,15737,15965
4347,operating,291000000,2,21-03-2012,10-03-2015,1,1084,15420,16504
4348,operating,,1,07-07-2013,07-07-2013,1,0,15893,15893
4349,closed,80500000,2,21-04-2006,22-05-2009,11,1127,13259,14386
4350,operating,125000,1,20-09-2012,20-09-2012,4,0,15603,15603
4351,operating,5607625,3,01-09-2012,31-03-2014,8,576,15584,16160
4352,operating,1500000,1,01-04-2011,01-04-2011,1,0,15065,15065
4353,closed,400000,1,18-03-2015,18-03-2015,1,0,16512,16512
4354,operating,,1,22-09-2015,22-09-2015,1,0,16700,16700
4355,closed,275000,1,01-11-2010,01-11-2010,3,0,14914,14914
4356,operating,5200000,3,22-05-2010,14-05-2015,16,1818,14751,16569
4357,operating,40299989,4,19-04-2014,11-08-2015,6,479,16179,16658
4358,closed,5000000,1,01-06-2007,01-06-2007,2,0,13665,13665
4359,operating,1500000,3,01-01-2014,14-07-2015,19,559,16071,16630
4360,operating,2400000,1,17-07-2013,17-07-2013,5,0,15903,15903
4361,operating,14699973,4,01-05-2007,09-11-2011,1,1653,13634,15287
4362,ipo,76800000,3,20-05-2003,29-11-2006,8,1289,12192,13481
4363,operating,5800000,1,13-06-2007,13-06-2007,2,0,13677,13677
4364,operating,,1,09-03-2015,09-03-2015,1,0,16503,16503
4365,operating,,1,02-12-2014,02-12-2014,3,0,16406,16406
4366,acquired,,1,01-01-2009,01-01-2009,1,0,14245,14245
4367,closed,1210000,1,15-06-2005,15-06-2005,2,0,12949,12949
4368,operating,20993787,3,11-12-2012,07-01-2015,4,757,15685,16442
4369,operating,129320,3,01-09-2009,18-03-2013,1,1294,14488,15782
4370,operating,13382106,2,05-06-2013,15-07-2015,1,770,15861,16631
4371,operating,28219452,4,02-04-2013,02-12-2015,7,974,15797,16771
4372,operating,350000000,2,01-03-2010,19-11-2014,3,1724,14669,16393
4373,operating,120000,1,16-07-2014,16-07-2014,1,0,16267,16267
4374,acquired,65000000,3,01-01-2006,01-02-2008,20,761,13149,13910
4375,closed,700000,3,22-04-2012,01-11-2013,1,558,15452,16010
4376,operating,385851,2,01-01-2014,05-05-2015,1,489,16071,16560
4377,operating,,1,09-06-2015,09-06-2015,1,0,16595,16595
4378,operating,1800000,2,12-07-2012,18-06-2013,9,341,15533,15874
4379,operating,250000,1,19-10-2011,19-10-2011,1,0,15266,15266
4380,operating,40000,1,08-03-2012,08-03-2012,1,0,15407,15407
4381,operating,373275,1,01-03-2011,01-03-2011,1,0,15034,15034
4382,operating,4700000,2,31-07-2012,03-07-2014,12,702,15552,16254
4383,operating,15000000,1,17-06-2014,17-06-2014,3,0,16238,16238
4384,operating,70000,1,01-09-2012,01-09-2012,1,0,15584,15584
4385,operating,,1,01-01-2014,01-01-2014,1,0,16071,16071
4386,operating,1500000,1,06-05-2014,06-05-2014,4,0,16196,16196
4387,closed,250000,1,23-03-2008,23-03-2008,2,0,13961,13961
4388,operating,250000000,2,01-11-2009,01-03-2012,3,851,14549,15400
4389,closed,35000000,2,03-03-2007,09-12-2009,13,1012,13575,14587
4390,operating,,1,01-01-2011,01-01-2011,1,0,14975,14975
4391,operating,300000,1,23-11-2015,23-11-2015,1,0,16762,16762
4392,operating,,1,05-05-2015,05-05-2015,1,0,16560,16560
4393,acquired,10000000,1,31-12-2008,31-12-2008,3,0,14244,14244
4394,operating,44050000,5,10-06-2011,08-10-2015,10,1581,15135,16716
4395,operating,4159800,2,17-04-2013,12-11-2013,5,209,15812,16021
4396,acquired,5000000,1,18-05-2007,18-05-2007,1,0,13651,13651
4397,operating,4868000,5,01-01-2011,08-10-2015,22,1741,14975,16716
4398,operating,24000000,3,21-05-2013,18-11-2015,10,911,15846,16757
4399,acquired,11000000,4,29-05-2006,21-09-2010,16,1576,13297,14873
4400,operating,144439,2,01-03-2011,01-11-2011,1,245,15034,15279
4401,acquired,,2,01-05-2010,16-09-2011,6,503,14730,15233
4402,operating,27000000,3,16-09-2009,16-05-2013,10,1338,14503,15841
4403,operating,3616966,7,01-03-2012,01-09-2013,9,549,15400,15949
4404,operating,4450000,2,04-06-2014,01-12-2015,1,545,16225,16770
4405,operating,183000000,3,07-07-2008,04-11-2014,5,2311,14067,16378
4406,operating,15200000,1,06-06-2001,06-06-2001,5,0,11479,11479
4407,operating,20000,1,02-04-2013,02-04-2013,1,0,15797,15797
4408,operating,1077500,3,06-06-2012,22-02-2013,4,261,15497,15758
4409,operating,141525,3,27-08-2013,06-07-2015,2,678,15944,16622
4410,operating,240000,1,28-05-2015,28-05-2015,1,0,16583,16583
4411,operating,6500000,1,18-02-2007,18-02-2007,3,0,13562,13562
4412,ipo,,1,30-11-1995,30-11-1995,1,0,9464,9464
4413,operating,68694,2,01-11-2013,01-05-2014,1,181,16010,16191
4414,closed,16781,1,02-03-2015,02-03-2015,1,0,16496,16496
4415,acquired,2960000,1,30-08-2007,30-08-2007,1,0,13755,13755
4416,operating,400000,2,30-05-2012,01-05-2013,3,336,15490,15826
4417,operating,12200000,3,20-04-2011,20-10-2015,10,1644,15084,16728
4418,operating,160000,2,19-02-2013,17-12-2013,1,301,15755,16056
4419,operating,152500,2,01-05-2013,11-11-2013,1,194,15826,16020
4420,operating,,1,01-06-2015,01-06-2015,1,0,16587,16587
4421,operating,16000000,3,09-08-2010,13-11-2012,2,827,14830,15657
4422,operating,28960995,1,20-01-2015,20-01-2015,2,0,16455,16455
4423,operating,16249,1,19-07-2015,19-07-2015,1,0,16635,16635
4424,operating,17100000,3,09-02-2010,03-10-2013,7,1332,14649,15981
4425,closed,13000000,1,06-04-2005,06-04-2005,5,0,12879,12879
4426,operating,3187382.313,7,30-11-2012,12-09-2015,3,1016,15674,16690
4427,operating,,1,03-12-2013,03-12-2013,1,0,16042,16042
4428,operating,,1,01-07-2012,01-07-2012,1,0,15522,15522
4429,operating,,1,09-06-2015,09-06-2015,1,0,16595,16595
4430,operating,48484,2,29-10-2014,26-05-2015,4,209,16372,16581
4431,operating,,1,01-01-2014,01-01-2014,2,0,16071,16071
4432,operating,28002500,3,15-03-2007,15-04-2010,3,1127,13587,14714
4433,operating,1500000,1,12-10-2015,12-10-2015,2,0,16720,16720
4434,operating,1200000,2,10-08-2011,19-01-2012,3,162,15196,15358
4435,acquired,,1,01-11-2004,01-11-2004,1,0,12723,12723
4436,closed,100000,1,01-08-2010,01-08-2010,1,0,14822,14822
4437,acquired,74800000,5,01-11-2010,10-01-2014,53,1166,14914,16080
4438,operating,247545839,17,04-06-2003,01-12-2015,57,4563,12207,16770
4439,operating,,2,01-01-2013,17-09-2014,2,624,15706,16330
4440,operating,,1,18-12-2009,18-12-2009,1,0,14596,14596
4441,operating,56170000,2,08-01-2007,17-04-2008,8,465,13521,13986
4442,acquired,20000000,1,13-12-2007,13-12-2007,2,0,13860,13860
4443,closed,1550000,1,01-02-2015,01-02-2015,1,0,16467,16467
4444,operating,,1,08-07-2013,08-07-2013,4,0,15894,15894
4445,operating,12951250,3,30-09-2009,29-03-2013,6,1276,14517,15793
4446,acquired,,1,01-05-2007,01-05-2007,1,0,13634,13634
4447,acquired,37600000,4,10-10-2003,28-03-2008,7,1631,12335,13966
4448,operating,,1,07-02-2012,07-02-2012,1,0,15377,15377
4449,closed,7500000,3,01-06-2005,30-09-2009,10,1582,12935,14517
4450,closed,32000000,1,17-10-2005,17-10-2005,6,0,13073,13073
4451,operating,75000,1,30-03-2015,30-03-2015,2,0,16524,16524
4452,operating,115000000,2,09-12-2013,28-09-2015,5,658,16048,16706
4453,operating,19000000,2,01-11-2010,24-06-2014,8,1331,14914,16245
4454,acquired,5660000,5,01-06-2000,17-03-2008,5,2846,11109,13955
4455,ipo,76500000,3,18-05-2009,24-06-2011,10,767,14382,15149
4456,acquired,35000035,2,02-05-2006,31-03-2009,1,1064,13270,14334
4457,operating,178000000,3,06-06-2011,05-02-2013,3,610,15131,15741
4458,operating,483333,1,01-08-2011,01-08-2011,2,0,15187,15187
4459,operating,,1,03-02-2015,03-02-2015,1,0,16469,16469
4460,operating,5782738,3,21-03-2007,07-03-2013,4,2178,13593,15771
4461,operating,1625065,1,21-07-2015,21-07-2015,6,0,16637,16637
4462,operating,,1,01-11-2011,01-11-2011,1,0,15279,15279
4463,closed,,1,28-04-2014,28-04-2014,1,0,16188,16188
4464,operating,,1,01-06-2009,01-06-2009,1,0,14396,14396
4465,operating,218000,1,28-07-2005,28-07-2005,2,0,12992,12992
4466,closed,1569585,2,01-04-2008,25-08-2011,3,1241,13970,15211
4467,operating,544701.1354,3,01-05-2014,21-11-2015,3,569,16191,16760
4468,operating,11750000,3,31-08-2013,18-09-2014,9,383,15948,16331
